number of entries 117
deathmatch_pbullets 1
deathmatch_pbullets_damage 5
suicide_pbullets 1
[ gm][  pc][p][cm]
[  0][   0]-------------START (level:42)------------- 
[  1][   0]-------------PLAYER 0 ACTIVE (color:8)-- 
[  2][  30][0][ 1]  [    ][    ][    ][  ][     ][LEFT]
[  3][  33][0][ 3]  [    ][    ][    ][  ][RIGHT][LEFT]
[  4][  35][0][ 2]  [    ][    ][    ][  ][RIGHT][    ]
[  5][  38][0][18]  [    ][JUMP][    ][  ][RIGHT][    ]
[  6][  40][0][19]  [    ][JUMP][    ][  ][RIGHT][LEFT]
[  7][  42][0][51]  [FIRE][JUMP][    ][  ][RIGHT][LEFT]
[  8][  44][0][35]  [FIRE][    ][    ][  ][RIGHT][LEFT]
[  9][  46][0][38]  [FIRE][    ][    ][UP][RIGHT][    ]
[ 10][  49][0][ 6]  [    ][    ][    ][UP][RIGHT][    ]
[ 11][  51][0][22]  [    ][JUMP][    ][UP][RIGHT][    ]
[ 12][  53][0][23]  [    ][JUMP][    ][UP][RIGHT][LEFT]
[ 13][  55][0][38]  [FIRE][    ][    ][UP][RIGHT][    ]
[ 14][  60][0][22]  [    ][JUMP][    ][UP][RIGHT][    ]
[ 15][  61][0][18]  [    ][JUMP][    ][  ][RIGHT][    ]
[ 16][  64][0][ 0]  [    ][    ][    ][  ][     ][    ]
[ 17][  66][0][32]  [FIRE][    ][    ][  ][     ][    ]
[ 18][  71][0][ 0]  [    ][    ][    ][  ][     ][    ]
[ 19][  72][0][16]  [    ][JUMP][    ][  ][     ][    ]
[ 20][  75][0][48]  [FIRE][JUMP][    ][  ][     ][    ]
[ 21][  77][0][ 0]  [    ][    ][    ][  ][     ][    ]
[ 22][  81][0][16]  [    ][JUMP][    ][  ][     ][    ]
[ 23][  82][0][48]  [FIRE][JUMP][    ][  ][     ][    ]
[ 24][  84][0][50]  [FIRE][JUMP][    ][  ][RIGHT][    ]
[ 25][  85][0][34]  [FIRE][    ][    ][  ][RIGHT][    ]
[ 26][  86][0][ 0]  [    ][    ][    ][  ][     ][    ]
[ 27][  89][0][16]  [    ][JUMP][    ][  ][     ][    ]
[ 28][  90][0][48]  [FIRE][JUMP][    ][  ][     ][    ]
[ 29][  92][0][ 0]  [    ][    ][    ][  ][     ][    ]
[ 30][  97][0][48]  [FIRE][JUMP][    ][  ][     ][    ]
[ 31][ 100][0][ 0]  [    ][    ][    ][  ][     ][    ]
[ 32][ 101][0][ 2]  [    ][    ][    ][  ][RIGHT][    ]
[ 33][ 107][0][ 0]  [    ][    ][    ][  ][     ][    ]
[ 34][ 108][0][ 1]  [    ][    ][    ][  ][     ][LEFT]
[ 35][ 113][0][ 3]  [    ][    ][    ][  ][RIGHT][LEFT]
[ 36][ 115][0][ 6]  [    ][    ][    ][UP][RIGHT][    ]
[ 37][ 118][0][ 2]  [    ][    ][    ][  ][RIGHT][    ]
[ 38][ 119][0][ 1]  [    ][    ][    ][  ][     ][LEFT]
[ 39][ 122][0][ 0]  [    ][    ][    ][  ][     ][    ]
[ 40][ 124][0][ 6]  [    ][    ][    ][UP][RIGHT][    ]
[ 41][ 127][0][ 0]  [    ][    ][    ][  ][     ][    ]
[ 42][ 128][0][ 1]  [    ][    ][    ][  ][     ][LEFT]
[ 43][ 131][0][ 0]  [    ][    ][    ][  ][     ][    ]
[ 44][ 133][0][ 2]  [    ][    ][    ][  ][RIGHT][    ]
[ 45][ 139][0][ 0]  [    ][    ][    ][  ][     ][    ]
[ 46][ 140][0][ 1]  [    ][    ][    ][  ][     ][LEFT]
[ 47][ 144][0][ 3]  [    ][    ][    ][  ][RIGHT][LEFT]
[ 48][ 145][0][ 2]  [    ][    ][    ][  ][RIGHT][    ]
[ 49][ 168][0][ 0]  [    ][    ][    ][  ][     ][    ]
[ 50][ 182][0][16]  [    ][JUMP][    ][  ][     ][    ]
[ 51][ 187][0][48]  [FIRE][JUMP][    ][  ][     ][    ]
[ 52][ 192][0][32]  [FIRE][    ][    ][  ][     ][    ]
[ 53][ 196][0][36]  [FIRE][    ][    ][UP][     ][    ]
[ 54][ 197][0][ 4]  [    ][    ][    ][UP][     ][    ]
[ 55][ 205][0][ 6]  [    ][    ][    ][UP][RIGHT][    ]
[ 56][ 208][0][ 1]  [    ][    ][    ][  ][     ][LEFT]
[ 57][ 210][0][17]  [    ][JUMP][    ][  ][     ][LEFT]
[ 58][ 218][0][ 1]  [    ][    ][    ][  ][     ][LEFT]
[ 59][ 230][0][ 0]  [    ][    ][    ][  ][     ][    ]
[ 60][ 233][0][16]  [    ][JUMP][    ][  ][     ][    ]
[ 61][ 247][0][ 0]  [    ][    ][    ][  ][     ][    ]
[ 62][ 248][0][ 2]  [    ][    ][    ][  ][RIGHT][    ]
[ 63][ 254][0][ 1]  [    ][    ][    ][  ][     ][LEFT]
[ 64][ 258][0][ 3]  [    ][    ][    ][  ][RIGHT][LEFT]
[ 65][ 259][0][ 2]  [    ][    ][    ][  ][RIGHT][    ]
[ 66][ 262][0][ 0]  [    ][    ][    ][  ][     ][    ]
[ 67][ 263][0][ 1]  [    ][    ][    ][  ][     ][LEFT]
[ 68][ 266][0][ 0]  [    ][    ][    ][  ][     ][    ]
[ 69][ 267][0][ 2]  [    ][    ][    ][  ][RIGHT][    ]
[ 70][ 271][0][ 0]  [    ][    ][    ][  ][     ][    ]
[ 71][ 272][0][ 1]  [    ][    ][    ][  ][     ][LEFT]
[ 72][ 276][0][ 2]  [    ][    ][    ][  ][RIGHT][    ]
[ 73][ 286][0][ 0]  [    ][    ][    ][  ][     ][    ]
[ 74][ 293][0][ 2]  [    ][    ][    ][  ][RIGHT][    ]
[ 75][ 304][0][ 0]  [    ][    ][    ][  ][     ][    ]
[ 76][ 311][0][ 2]  [    ][    ][    ][  ][RIGHT][    ]
[ 77][ 319][0][ 0]  [    ][    ][    ][  ][     ][    ]
[ 78][ 325][0][ 2]  [    ][    ][    ][  ][RIGHT][    ]
[ 79][ 330][0][18]  [    ][JUMP][    ][  ][RIGHT][    ]
[ 80][ 331][0][16]  [    ][JUMP][    ][  ][     ][    ]
[ 81][ 337][0][18]  [    ][JUMP][    ][  ][RIGHT][    ]
[ 82][ 338][0][ 2]  [    ][    ][    ][  ][RIGHT][    ]
[ 83][ 343][0][ 0]  [    ][    ][    ][  ][     ][    ]
[ 84][ 372][0][ 2]  [    ][    ][    ][  ][RIGHT][    ]
[ 85][ 377][0][ 0]  [    ][    ][    ][  ][     ][    ]
[ 86][ 378][0][16]  [    ][JUMP][    ][  ][     ][    ]
[ 87][ 384][0][18]  [    ][JUMP][    ][  ][RIGHT][    ]
[ 88][ 389][0][ 2]  [    ][    ][    ][  ][RIGHT][    ]
[ 89][ 396][0][ 0]  [    ][    ][    ][  ][     ][    ]
[ 90][ 426][0][ 2]  [    ][    ][    ][  ][RIGHT][    ]
[ 91][ 434][0][ 6]  [    ][    ][    ][UP][RIGHT][    ]
[ 92][ 438][0][38]  [FIRE][    ][    ][UP][RIGHT][    ]
[ 93][ 442][0][ 4]  [    ][    ][    ][UP][     ][    ]
[ 94][ 446][0][36]  [FIRE][    ][    ][UP][     ][    ]
[ 95][ 448][0][38]  [FIRE][    ][    ][UP][RIGHT][    ]
[ 96][ 449][0][ 6]  [    ][    ][    ][UP][RIGHT][    ]
[ 97][ 452][0][ 4]  [    ][    ][    ][UP][     ][    ]
[ 98][ 454][0][37]  [FIRE][    ][    ][UP][     ][LEFT]
[ 99][ 456][0][ 5]  [    ][    ][    ][UP][     ][LEFT]
[100][ 460][0][ 4]  [    ][    ][    ][UP][     ][    ]
[101][ 461][0][36]  [FIRE][    ][    ][UP][     ][    ]
[102][ 462][0][38]  [FIRE][    ][    ][UP][RIGHT][    ]
[103][ 463][0][ 6]  [    ][    ][    ][UP][RIGHT][    ]
[104][ 468][0][38]  [FIRE][    ][    ][UP][RIGHT][    ]
[105][ 470][0][ 6]  [    ][    ][    ][UP][RIGHT][    ]
[106][ 475][0][38]  [FIRE][    ][    ][UP][RIGHT][    ]
[107][ 477][0][ 6]  [    ][    ][    ][UP][RIGHT][    ]
[108][ 483][0][22]  [    ][JUMP][    ][UP][RIGHT][    ]
[109][ 484][0][16]  [    ][JUMP][    ][  ][     ][    ]
[110][ 485][0][17]  [    ][JUMP][    ][  ][     ][LEFT]
[111][ 498][0][ 1]  [    ][    ][    ][  ][     ][LEFT]
[112][ 502]-------------LEVEL DONE 1 ---------------- 
[113][ 582]-------------LEVEL DONE 2 ---------------- 
[114][1302]-------------NEXT LEVEL!------------------ 
[115][ 583]-------------PLAYER 0 ACKNOWLEDGE------ 
[116][ 584]-------------NEXT LEVEL!------------------ 
