number of entries 150
deathmatch_pbullets 1
deathmatch_pbullets_damage 5
suicide_pbullets 1
[ gm][  pc][p][cm]
[  0][   0]-------------START (level:41)------------- 
[  1][   0]-------------PLAYER 0 ACTIVE (color:8)-- 
[  2][  25][0][ 2]  [    ][    ][    ][  ][RIGHT][    ]
[  3][  36][0][ 0]  [    ][    ][    ][  ][     ][    ]
[  4][  41][0][ 2]  [    ][    ][    ][  ][RIGHT][    ]
[  5][  54][0][34]  [FIRE][    ][    ][  ][RIGHT][    ]
[  6][  58][0][ 2]  [    ][    ][    ][  ][RIGHT][    ]
[  7][  62][0][32]  [FIRE][    ][    ][  ][     ][    ]
[  8][  64][0][ 0]  [    ][    ][    ][  ][     ][    ]
[  9][  68][0][32]  [FIRE][    ][    ][  ][     ][    ]
[ 10][  69][0][34]  [FIRE][    ][    ][  ][RIGHT][    ]
[ 11][  71][0][ 2]  [    ][    ][    ][  ][RIGHT][    ]
[ 12][  73][0][34]  [FIRE][    ][    ][  ][RIGHT][    ]
[ 13][  74][0][50]  [FIRE][JUMP][    ][  ][RIGHT][    ]
[ 14][  78][0][18]  [    ][JUMP][    ][  ][RIGHT][    ]
[ 15][  80][0][16]  [    ][JUMP][    ][  ][     ][    ]
[ 16][  84][0][49]  [FIRE][JUMP][    ][  ][     ][LEFT]
[ 17][  86][0][33]  [FIRE][    ][    ][  ][     ][LEFT]
[ 18][  88][0][ 0]  [    ][    ][    ][  ][     ][    ]
[ 19][  90][0][16]  [    ][JUMP][    ][  ][     ][    ]
[ 20][  92][0][48]  [FIRE][JUMP][    ][  ][     ][    ]
[ 21][  93][0][32]  [FIRE][    ][    ][  ][     ][    ]
[ 22][  94][0][ 0]  [    ][    ][    ][  ][     ][    ]
[ 23][  98][0][17]  [    ][JUMP][    ][  ][     ][LEFT]
[ 24][  99][0][49]  [FIRE][JUMP][    ][  ][     ][LEFT]
[ 25][ 102][0][ 1]  [    ][    ][    ][  ][     ][LEFT]
[ 26][ 104][0][ 0]  [    ][    ][    ][  ][     ][    ]
[ 27][ 105][0][ 2]  [    ][    ][    ][  ][RIGHT][    ]
[ 28][ 106][0][50]  [FIRE][JUMP][    ][  ][RIGHT][    ]
[ 29][ 111][0][17]  [    ][JUMP][    ][  ][     ][LEFT]
[ 30][ 116][0][51]  [FIRE][JUMP][    ][  ][RIGHT][LEFT]
[ 31][ 117][0][34]  [FIRE][    ][    ][  ][RIGHT][    ]
[ 32][ 119][0][38]  [FIRE][    ][    ][UP][RIGHT][    ]
[ 33][ 120][0][22]  [    ][JUMP][    ][UP][RIGHT][    ]
[ 34][ 122][0][21]  [    ][JUMP][    ][UP][     ][LEFT]
[ 35][ 123][0][17]  [    ][JUMP][    ][  ][     ][LEFT]
[ 36][ 125][0][32]  [FIRE][    ][    ][  ][     ][    ]
[ 37][ 127][0][ 0]  [    ][    ][    ][  ][     ][    ]
[ 38][ 129][0][ 1]  [    ][    ][    ][  ][     ][LEFT]
[ 39][ 131][0][32]  [FIRE][    ][    ][  ][     ][    ]
[ 40][ 134][0][ 0]  [    ][    ][    ][  ][     ][    ]
[ 41][ 138][0][32]  [FIRE][    ][    ][  ][     ][    ]
[ 42][ 141][0][ 0]  [    ][    ][    ][  ][     ][    ]
[ 43][ 144][0][32]  [FIRE][    ][    ][  ][     ][    ]
[ 44][ 145][0][48]  [FIRE][JUMP][    ][  ][     ][    ]
[ 45][ 149][0][16]  [    ][JUMP][    ][  ][     ][    ]
[ 46][ 152][0][17]  [    ][JUMP][    ][  ][     ][LEFT]
[ 47][ 157][0][49]  [FIRE][JUMP][    ][  ][     ][LEFT]
[ 48][ 158][0][32]  [FIRE][    ][    ][  ][     ][    ]
[ 49][ 160][0][ 0]  [    ][    ][    ][  ][     ][    ]
[ 50][ 163][0][32]  [FIRE][    ][    ][  ][     ][    ]
[ 51][ 166][0][ 0]  [    ][    ][    ][  ][     ][    ]
[ 52][ 170][0][32]  [FIRE][    ][    ][  ][     ][    ]
[ 53][ 172][0][ 0]  [    ][    ][    ][  ][     ][    ]
[ 54][ 176][0][32]  [FIRE][    ][    ][  ][     ][    ]
[ 55][ 179][0][ 0]  [    ][    ][    ][  ][     ][    ]
[ 56][ 184][0][32]  [FIRE][    ][    ][  ][     ][    ]
[ 57][ 186][0][ 0]  [    ][    ][    ][  ][     ][    ]
[ 58][ 187][0][ 2]  [    ][    ][    ][  ][RIGHT][    ]
[ 59][ 198][0][34]  [FIRE][    ][    ][  ][RIGHT][    ]
[ 60][ 213][0][32]  [FIRE][    ][    ][  ][     ][    ]
[ 61][ 216][0][34]  [FIRE][    ][    ][  ][RIGHT][    ]
[ 62][ 224][0][50]  [FIRE][JUMP][    ][  ][RIGHT][    ]
[ 63][ 226][0][48]  [FIRE][JUMP][    ][  ][     ][    ]
[ 64][ 232][0][16]  [    ][JUMP][    ][  ][     ][    ]
[ 65][ 234][0][ 0]  [    ][    ][    ][  ][     ][    ]
[ 66][ 241][0][ 2]  [    ][    ][    ][  ][RIGHT][    ]
[ 67][ 247][0][ 0]  [    ][    ][    ][  ][     ][    ]
[ 68][ 249][0][ 1]  [    ][    ][    ][  ][     ][LEFT]
[ 69][ 253][0][ 0]  [    ][    ][    ][  ][     ][    ]
[ 70][ 255][0][ 2]  [    ][    ][    ][  ][RIGHT][    ]
[ 71][ 267][0][ 0]  [    ][    ][    ][  ][     ][    ]
[ 72][ 320][0][16]  [    ][JUMP][    ][  ][     ][    ]
[ 73][ 333][0][ 0]  [    ][    ][    ][  ][     ][    ]
[ 74][ 354][0][32]  [FIRE][    ][    ][  ][     ][    ]
[ 75][ 359][0][34]  [FIRE][    ][    ][  ][RIGHT][    ]
[ 76][ 374][0][32]  [FIRE][    ][    ][  ][     ][    ]
[ 77][ 382][0][ 0]  [    ][    ][    ][  ][     ][    ]
[ 78][ 387][0][16]  [    ][JUMP][    ][  ][     ][    ]
[ 79][ 393][0][18]  [    ][JUMP][    ][  ][RIGHT][    ]
[ 80][ 395][0][ 2]  [    ][    ][    ][  ][RIGHT][    ]
[ 81][ 400][0][ 0]  [    ][    ][    ][  ][     ][    ]
[ 82][ 414][0][ 2]  [    ][    ][    ][  ][RIGHT][    ]
[ 83][ 435][0][18]  [    ][JUMP][    ][  ][RIGHT][    ]
[ 84][ 439][0][16]  [    ][JUMP][    ][  ][     ][    ]
[ 85][ 445][0][ 0]  [    ][    ][    ][  ][     ][    ]
[ 86][ 446][0][ 1]  [    ][    ][    ][  ][     ][LEFT]
[ 87][ 457][0][ 0]  [    ][    ][    ][  ][     ][    ]
[ 88][ 460][0][32]  [FIRE][    ][    ][  ][     ][    ]
[ 89][ 461][0][36]  [FIRE][    ][    ][UP][     ][    ]
[ 90][ 464][0][ 4]  [    ][    ][    ][UP][     ][    ]
[ 91][ 469][0][37]  [FIRE][    ][    ][UP][     ][LEFT]
[ 92][ 471][0][ 1]  [    ][    ][    ][  ][     ][LEFT]
[ 93][ 473][0][ 0]  [    ][    ][    ][  ][     ][    ]
[ 94][ 476][0][16]  [    ][JUMP][    ][  ][     ][    ]
[ 95][ 477][0][17]  [    ][JUMP][    ][  ][     ][LEFT]
[ 96][ 481][0][16]  [    ][JUMP][    ][  ][     ][    ]
[ 97][ 483][0][48]  [FIRE][JUMP][    ][  ][     ][    ]
[ 98][ 484][0][32]  [FIRE][    ][    ][  ][     ][    ]
[ 99][ 487][0][ 0]  [    ][    ][    ][  ][     ][    ]
[100][ 488][0][ 1]  [    ][    ][    ][  ][     ][LEFT]
[101][ 500][0][ 0]  [    ][    ][    ][  ][     ][    ]
[102][ 521][0][16]  [    ][JUMP][    ][  ][     ][    ]
[103][ 526][0][ 0]  [    ][    ][    ][  ][     ][    ]
[104][ 544][0][16]  [    ][JUMP][    ][  ][     ][    ]
[105][ 552][0][ 0]  [    ][    ][    ][  ][     ][    ]
[106][ 556][0][ 2]  [    ][    ][    ][  ][RIGHT][    ]
[107][ 566][0][ 0]  [    ][    ][    ][  ][     ][    ]
[108][ 584][0][ 2]  [    ][    ][    ][  ][RIGHT][    ]
[109][ 609][0][ 6]  [    ][    ][    ][UP][RIGHT][    ]
[110][ 616][0][38]  [FIRE][    ][    ][UP][RIGHT][    ]
[111][ 618][0][36]  [FIRE][    ][    ][UP][     ][    ]
[112][ 621][0][ 4]  [    ][    ][    ][UP][     ][    ]
[113][ 622][0][ 6]  [    ][    ][    ][UP][RIGHT][    ]
[114][ 625][0][ 2]  [    ][    ][    ][  ][RIGHT][    ]
[115][ 655][0][ 0]  [    ][    ][    ][  ][     ][    ]
[116][ 657][0][ 1]  [    ][    ][    ][  ][     ][LEFT]
[117][ 661][0][ 5]  [    ][    ][    ][UP][     ][LEFT]
[118][ 662][0][ 4]  [    ][    ][    ][UP][     ][    ]
[119][ 671][0][ 6]  [    ][    ][    ][UP][RIGHT][    ]
[120][ 678][0][38]  [FIRE][    ][    ][UP][RIGHT][    ]
[121][ 680][0][36]  [FIRE][    ][    ][UP][     ][    ]
[122][ 681][0][ 4]  [    ][    ][    ][UP][     ][    ]
[123][ 686][0][36]  [FIRE][    ][    ][UP][     ][    ]
[124][ 688][0][ 4]  [    ][    ][    ][UP][     ][    ]
[125][ 693][0][36]  [FIRE][    ][    ][UP][     ][    ]
[126][ 696][0][ 4]  [    ][    ][    ][UP][     ][    ]
[127][ 700][0][36]  [FIRE][    ][    ][UP][     ][    ]
[128][ 703][0][ 4]  [    ][    ][    ][UP][     ][    ]
[129][ 706][0][36]  [FIRE][    ][    ][UP][     ][    ]
[130][ 710][0][37]  [FIRE][    ][    ][UP][     ][LEFT]
[131][ 711][0][ 5]  [    ][    ][    ][UP][     ][LEFT]
[132][ 712][0][ 1]  [    ][    ][    ][  ][     ][LEFT]
[133][ 743][0][17]  [    ][JUMP][    ][  ][     ][LEFT]
[134][ 745][0][16]  [    ][JUMP][    ][  ][     ][    ]
[135][ 751][0][18]  [    ][JUMP][    ][  ][RIGHT][    ]
[136][ 782][0][ 2]  [    ][    ][    ][  ][RIGHT][    ]
[137][ 783][0][ 0]  [    ][    ][    ][  ][     ][    ]
[138][ 794][0][ 1]  [    ][    ][    ][  ][     ][LEFT]
[139][ 798][0][ 0]  [    ][    ][    ][  ][     ][    ]
[140][ 810][0][ 2]  [    ][    ][    ][  ][RIGHT][    ]
[141][ 816][0][ 0]  [    ][    ][    ][  ][     ][    ]
[142][ 821][0][ 2]  [    ][    ][    ][  ][RIGHT][    ]
[143][ 827][0][ 0]  [    ][    ][    ][  ][     ][    ]
[144][ 830][0][16]  [    ][JUMP][    ][  ][     ][    ]
[145][ 838]-------------LEVEL DONE 1 ---------------- 
[146][ 918]-------------LEVEL DONE 2 ---------------- 
[147][1638]-------------NEXT LEVEL!------------------ 
[148][ 919]-------------PLAYER 0 ACKNOWLEDGE------ 
[149][ 920]-------------NEXT LEVEL!------------------ 
