number of entries 74
deathmatch_pbullets 0
deathmatch_pbullets_damage 5
suicide_pbullets 0
[ gm][  pc][p][cm]
[  0][   0]-------------START (level:40)------------- 
[  1][   0]-------------PLAYER 0 ACTIVE (color:8)-- 
[  2][  25][0][ 2]  [    ][    ][    ][  ][RIGHT][    ]
[  3][  42][0][18]  [    ][JUMP][    ][  ][RIGHT][    ]
[  4][  48][0][50]  [FIRE][JUMP][    ][  ][RIGHT][    ]
[  5][  51][0][34]  [FIRE][    ][    ][  ][RIGHT][    ]
[  6][  52][0][ 2]  [    ][    ][    ][  ][RIGHT][    ]
[  7][  57][0][34]  [FIRE][    ][    ][  ][RIGHT][    ]
[  8][  60][0][ 2]  [    ][    ][    ][  ][RIGHT][    ]
[  9][  64][0][34]  [FIRE][    ][    ][  ][RIGHT][    ]
[ 10][  66][0][ 2]  [    ][    ][    ][  ][RIGHT][    ]
[ 11][  71][0][34]  [FIRE][    ][    ][  ][RIGHT][    ]
[ 12][  72][0][ 2]  [    ][    ][    ][  ][RIGHT][    ]
[ 13][  77][0][34]  [FIRE][    ][    ][  ][RIGHT][    ]
[ 14][  78][0][50]  [FIRE][JUMP][    ][  ][RIGHT][    ]
[ 15][  81][0][18]  [    ][JUMP][    ][  ][RIGHT][    ]
[ 16][  86][0][50]  [FIRE][JUMP][    ][  ][RIGHT][    ]
[ 17][  87][0][34]  [FIRE][    ][    ][  ][RIGHT][    ]
[ 18][  90][0][ 2]  [    ][    ][    ][  ][RIGHT][    ]
[ 19][ 108][0][18]  [    ][JUMP][    ][  ][RIGHT][    ]
[ 20][ 118][0][ 2]  [    ][    ][    ][  ][RIGHT][    ]
[ 21][ 119][0][ 0]  [    ][    ][    ][  ][     ][    ]
[ 22][ 120][0][ 1]  [    ][    ][    ][  ][     ][LEFT]
[ 23][ 125][0][ 0]  [    ][    ][    ][  ][     ][    ]
[ 24][ 128][0][16]  [    ][JUMP][    ][  ][     ][    ]
[ 25][ 147][0][ 1]  [    ][    ][    ][  ][     ][LEFT]
[ 26][ 152][0][ 0]  [    ][    ][    ][  ][     ][    ]
[ 27][ 154][0][16]  [    ][JUMP][    ][  ][     ][    ]
[ 28][ 196][0][17]  [    ][JUMP][    ][  ][     ][LEFT]
[ 29][ 200][0][ 1]  [    ][    ][    ][  ][     ][LEFT]
[ 30][ 215][0][ 0]  [    ][    ][    ][  ][     ][    ]
[ 31][ 218][0][ 2]  [    ][    ][    ][  ][RIGHT][    ]
[ 32][ 222][0][ 0]  [    ][    ][    ][  ][     ][    ]
[ 33][ 241][0][ 1]  [    ][    ][    ][  ][     ][LEFT]
[ 34][ 245][0][ 0]  [    ][    ][    ][  ][     ][    ]
[ 35][ 260][0][ 1]  [    ][    ][    ][  ][     ][LEFT]
[ 36][ 271][0][ 0]  [    ][    ][    ][  ][     ][    ]
[ 37][ 286][0][ 2]  [    ][    ][    ][  ][RIGHT][    ]
[ 38][ 292][0][ 0]  [    ][    ][    ][  ][     ][    ]
[ 39][ 295][0][16]  [    ][JUMP][    ][  ][     ][    ]
[ 40][ 319][0][ 0]  [    ][    ][    ][  ][     ][    ]
[ 41][ 320][0][ 2]  [    ][    ][    ][  ][RIGHT][    ]
[ 42][ 336][0][18]  [    ][JUMP][    ][  ][RIGHT][    ]
[ 43][ 356][0][ 2]  [    ][    ][    ][  ][RIGHT][    ]
[ 44][ 364][0][33]  [FIRE][    ][    ][  ][     ][LEFT]
[ 45][ 368][0][ 1]  [    ][    ][    ][  ][     ][LEFT]
[ 46][ 373][0][33]  [FIRE][    ][    ][  ][     ][LEFT]
[ 47][ 376][0][ 1]  [    ][    ][    ][  ][     ][LEFT]
[ 48][ 380][0][33]  [FIRE][    ][    ][  ][     ][LEFT]
[ 49][ 383][0][ 1]  [    ][    ][    ][  ][     ][LEFT]
[ 50][ 385][0][ 0]  [    ][    ][    ][  ][     ][    ]
[ 51][ 387][0][32]  [FIRE][    ][    ][  ][     ][    ]
[ 52][ 388][0][34]  [FIRE][    ][    ][  ][RIGHT][    ]
[ 53][ 390][0][ 2]  [    ][    ][    ][  ][RIGHT][    ]
[ 54][ 394][0][ 1]  [    ][    ][    ][  ][     ][LEFT]
[ 55][ 396][0][33]  [FIRE][    ][    ][  ][     ][LEFT]
[ 56][ 398][0][ 1]  [    ][    ][    ][  ][     ][LEFT]
[ 57][ 402][0][ 3]  [    ][    ][    ][  ][RIGHT][LEFT]
[ 58][ 403][0][ 2]  [    ][    ][    ][  ][RIGHT][    ]
[ 59][ 433][0][18]  [    ][JUMP][    ][  ][RIGHT][    ]
[ 60][ 466][0][ 2]  [    ][    ][    ][  ][RIGHT][    ]
[ 61][ 468][0][ 0]  [    ][    ][    ][  ][     ][    ]
[ 62][ 472][0][ 1]  [    ][    ][    ][  ][     ][LEFT]
[ 63][ 477][0][ 0]  [    ][    ][    ][  ][     ][    ]
[ 64][ 480][0][16]  [    ][JUMP][    ][  ][     ][    ]
[ 65][ 486][0][ 0]  [    ][    ][    ][  ][     ][    ]
[ 66][ 519][0][ 2]  [    ][    ][    ][  ][RIGHT][    ]
[ 67][ 531][0][ 0]  [    ][    ][    ][  ][     ][    ]
[ 68][ 532][0][16]  [    ][JUMP][    ][  ][     ][    ]
[ 69][ 540]-------------LEVEL DONE 1 ---------------- 
[ 70][ 620]-------------LEVEL DONE 2 ---------------- 
[ 71][1340]-------------NEXT LEVEL!------------------ 
[ 72][ 626]-------------PLAYER 0 ACKNOWLEDGE------ 
[ 73][ 627]-------------NEXT LEVEL!------------------ 
