number of entries 250
deathmatch_pbullets 0
deathmatch_pbullets_damage 5
suicide_pbullets 0
[ gm][  pc][p][cm]
[  0][   0]-------------START (level:40)------------- 
[  1][   0]-------------PLAYER 0 ACTIVE (color:8)-- 
[  2][  24][0][ 2]  [    ][    ][    ][  ][RIGHT][    ]
[  3][  40][0][ 0]  [    ][    ][    ][  ][     ][    ]
[  4][  43][0][ 1]  [    ][    ][    ][  ][     ][LEFT]
[  5][  46][0][ 3]  [    ][    ][    ][  ][RIGHT][LEFT]
[  6][  47][0][ 2]  [    ][    ][    ][  ][RIGHT][    ]
[  7][  69][0][ 0]  [    ][    ][    ][  ][     ][    ]
[  8][ 114][0][ 2]  [    ][    ][    ][  ][RIGHT][    ]
[  9][ 125][0][ 0]  [    ][    ][    ][  ][     ][    ]
[ 10][ 127][0][ 1]  [    ][    ][    ][  ][     ][LEFT]
[ 11][ 143][0][ 3]  [    ][    ][    ][  ][RIGHT][LEFT]
[ 12][ 144][0][ 2]  [    ][    ][    ][  ][RIGHT][    ]
[ 13][ 150][0][16]  [    ][JUMP][    ][  ][     ][    ]
[ 14][ 155][0][18]  [    ][JUMP][    ][  ][RIGHT][    ]
[ 15][ 161][0][16]  [    ][JUMP][    ][  ][     ][    ]
[ 16][ 162][0][ 1]  [    ][    ][    ][  ][     ][LEFT]
[ 17][ 165][0][ 3]  [    ][    ][    ][  ][RIGHT][LEFT]
[ 18][ 166][0][ 2]  [    ][    ][    ][  ][RIGHT][    ]
[ 19][ 176][0][ 1]  [    ][    ][    ][  ][     ][LEFT]
[ 20][ 182][0][ 0]  [    ][    ][    ][  ][     ][    ]
[ 21][ 184][0][16]  [    ][JUMP][    ][  ][     ][    ]
[ 22][ 188][0][ 0]  [    ][    ][    ][  ][     ][    ]
[ 23][ 197][0][ 2]  [    ][    ][    ][  ][RIGHT][    ]
[ 24][ 208][0][ 3]  [    ][    ][    ][  ][RIGHT][LEFT]
[ 25][ 209][0][ 1]  [    ][    ][    ][  ][     ][LEFT]
[ 26][ 212][0][17]  [    ][JUMP][    ][  ][     ][LEFT]
[ 27][ 219][0][49]  [FIRE][JUMP][    ][  ][     ][LEFT]
[ 28][ 220][0][33]  [FIRE][    ][    ][  ][     ][LEFT]
[ 29][ 223][0][ 1]  [    ][    ][    ][  ][     ][LEFT]
[ 30][ 228][0][33]  [FIRE][    ][    ][  ][     ][LEFT]
[ 31][ 231][0][ 1]  [    ][    ][    ][  ][     ][LEFT]
[ 32][ 233][0][ 3]  [    ][    ][    ][  ][RIGHT][LEFT]
[ 33][ 234][0][ 2]  [    ][    ][    ][  ][RIGHT][    ]
[ 34][ 236][0][34]  [FIRE][    ][    ][  ][RIGHT][    ]
[ 35][ 238][0][ 2]  [    ][    ][    ][  ][RIGHT][    ]
[ 36][ 240][0][ 0]  [    ][    ][    ][  ][     ][    ]
[ 37][ 242][0][32]  [FIRE][    ][    ][  ][     ][    ]
[ 38][ 245][0][ 0]  [    ][    ][    ][  ][     ][    ]
[ 39][ 249][0][32]  [FIRE][    ][    ][  ][     ][    ]
[ 40][ 252][0][ 0]  [    ][    ][    ][  ][     ][    ]
[ 41][ 256][0][48]  [FIRE][JUMP][    ][  ][     ][    ]
[ 42][ 260][0][16]  [    ][JUMP][    ][  ][     ][    ]
[ 43][ 265][0][48]  [FIRE][JUMP][    ][  ][     ][    ]
[ 44][ 267][0][32]  [FIRE][    ][    ][  ][     ][    ]
[ 45][ 268][0][ 0]  [    ][    ][    ][  ][     ][    ]
[ 46][ 270][0][16]  [    ][JUMP][    ][  ][     ][    ]
[ 47][ 272][0][48]  [FIRE][JUMP][    ][  ][     ][    ]
[ 48][ 273][0][16]  [    ][JUMP][    ][  ][     ][    ]
[ 49][ 274][0][ 0]  [    ][    ][    ][  ][     ][    ]
[ 50][ 277][0][32]  [FIRE][    ][    ][  ][     ][    ]
[ 51][ 281][0][ 0]  [    ][    ][    ][  ][     ][    ]
[ 52][ 283][0][ 2]  [    ][    ][    ][  ][RIGHT][    ]
[ 53][ 301][0][ 0]  [    ][    ][    ][  ][     ][    ]
[ 54][ 303][0][ 1]  [    ][    ][    ][  ][     ][LEFT]
[ 55][ 327][0][ 0]  [    ][    ][    ][  ][     ][    ]
[ 56][ 333][0][ 2]  [    ][    ][    ][  ][RIGHT][    ]
[ 57][ 359][0][ 0]  [    ][    ][    ][  ][     ][    ]
[ 58][ 361][0][ 1]  [    ][    ][    ][  ][     ][LEFT]
[ 59][ 393][0][ 0]  [    ][    ][    ][  ][     ][    ]
[ 60][ 394][0][ 2]  [    ][    ][    ][  ][RIGHT][    ]
[ 61][ 414][0][ 0]  [    ][    ][    ][  ][     ][    ]
[ 62][ 415][0][ 1]  [    ][    ][    ][  ][     ][LEFT]
[ 63][ 428][0][17]  [    ][JUMP][    ][  ][     ][LEFT]
[ 64][ 430][0][16]  [    ][JUMP][    ][  ][     ][    ]
[ 65][ 445][0][17]  [    ][JUMP][    ][  ][     ][LEFT]
[ 66][ 455][0][ 1]  [    ][    ][    ][  ][     ][LEFT]
[ 67][ 468][0][17]  [    ][JUMP][    ][  ][     ][LEFT]
[ 68][ 474][0][16]  [    ][JUMP][    ][  ][     ][    ]
[ 69][ 480][0][18]  [    ][JUMP][    ][  ][RIGHT][    ]
[ 70][ 485][0][50]  [FIRE][JUMP][    ][  ][RIGHT][    ]
[ 71][ 486][0][32]  [FIRE][    ][    ][  ][     ][    ]
[ 72][ 489][0][ 0]  [    ][    ][    ][  ][     ][    ]
[ 73][ 492][0][ 2]  [    ][    ][    ][  ][RIGHT][    ]
[ 74][ 493][0][34]  [FIRE][    ][    ][  ][RIGHT][    ]
[ 75][ 495][0][32]  [FIRE][    ][    ][  ][     ][    ]
[ 76][ 496][0][ 0]  [    ][    ][    ][  ][     ][    ]
[ 77][ 500][0][32]  [FIRE][    ][    ][  ][     ][    ]
[ 78][ 501][0][34]  [FIRE][    ][    ][  ][RIGHT][    ]
[ 79][ 504][0][ 0]  [    ][    ][    ][  ][     ][    ]
[ 80][ 507][0][16]  [    ][JUMP][    ][  ][     ][    ]
[ 81][ 508][0][48]  [FIRE][JUMP][    ][  ][     ][    ]
[ 82][ 511][0][16]  [    ][JUMP][    ][  ][     ][    ]
[ 83][ 516][0][48]  [FIRE][JUMP][    ][  ][     ][    ]
[ 84][ 518][0][32]  [FIRE][    ][    ][  ][     ][    ]
[ 85][ 520][0][ 0]  [    ][    ][    ][  ][     ][    ]
[ 86][ 522][0][16]  [    ][JUMP][    ][  ][     ][    ]
[ 87][ 528][0][48]  [FIRE][JUMP][    ][  ][     ][    ]
[ 88][ 529][0][32]  [FIRE][    ][    ][  ][     ][    ]
[ 89][ 533][0][48]  [FIRE][JUMP][    ][  ][     ][    ]
[ 90][ 534][0][16]  [    ][JUMP][    ][  ][     ][    ]
[ 91][ 538][0][48]  [FIRE][JUMP][    ][  ][     ][    ]
[ 92][ 539][0][32]  [FIRE][    ][    ][  ][     ][    ]
[ 93][ 543][0][48]  [FIRE][JUMP][    ][  ][     ][    ]
[ 94][ 545][0][16]  [    ][JUMP][    ][  ][     ][    ]
[ 95][ 548][0][17]  [    ][JUMP][    ][  ][     ][LEFT]
[ 96][ 556][0][ 1]  [    ][    ][    ][  ][     ][LEFT]
[ 97][ 557][0][ 3]  [    ][    ][    ][  ][RIGHT][LEFT]
[ 98][ 559][0][34]  [FIRE][    ][    ][  ][RIGHT][    ]
[ 99][ 563][0][ 0]  [    ][    ][    ][  ][     ][    ]
[100][ 566][0][32]  [FIRE][    ][    ][  ][     ][    ]
[101][ 571][0][ 0]  [    ][    ][    ][  ][     ][    ]
[102][ 575][0][32]  [FIRE][    ][    ][  ][     ][    ]
[103][ 579][0][ 0]  [    ][    ][    ][  ][     ][    ]
[104][ 585][0][ 2]  [    ][    ][    ][  ][RIGHT][    ]
[105][ 591][0][ 6]  [    ][    ][    ][UP][RIGHT][    ]
[106][ 592][0][22]  [    ][JUMP][    ][UP][RIGHT][    ]
[107][ 594][0][21]  [    ][JUMP][    ][UP][     ][LEFT]
[108][ 596][0][20]  [    ][JUMP][    ][UP][     ][    ]
[109][ 600][0][52]  [FIRE][JUMP][    ][UP][     ][    ]
[110][ 601][0][36]  [FIRE][    ][    ][UP][     ][    ]
[111][ 603][0][37]  [FIRE][    ][    ][UP][     ][LEFT]
[112][ 604][0][33]  [FIRE][    ][    ][  ][     ][LEFT]
[113][ 605][0][ 1]  [    ][    ][    ][  ][     ][LEFT]
[114][ 607][0][ 5]  [    ][    ][    ][UP][     ][LEFT]
[115][ 608][0][ 4]  [    ][    ][    ][UP][     ][    ]
[116][ 609][0][ 6]  [    ][    ][    ][UP][RIGHT][    ]
[117][ 612][0][ 4]  [    ][    ][    ][UP][     ][    ]
[118][ 615][0][ 0]  [    ][    ][    ][  ][     ][    ]
[119][ 617][0][ 2]  [    ][    ][    ][  ][RIGHT][    ]
[120][ 623][0][18]  [    ][JUMP][    ][  ][RIGHT][    ]
[121][ 642][0][19]  [    ][JUMP][    ][  ][RIGHT][LEFT]
[122][ 643][0][17]  [    ][JUMP][    ][  ][     ][LEFT]
[123][ 644][0][ 1]  [    ][    ][    ][  ][     ][LEFT]
[124][ 660][0][ 0]  [    ][    ][    ][  ][     ][    ]
[125][ 667][0][ 2]  [    ][    ][    ][  ][RIGHT][    ]
[126][ 675][0][18]  [    ][JUMP][    ][  ][RIGHT][    ]
[127][ 678][0][16]  [    ][JUMP][    ][  ][     ][    ]
[128][ 686][0][17]  [    ][JUMP][    ][  ][     ][LEFT]
[129][ 702][0][ 1]  [    ][    ][    ][  ][     ][LEFT]
[130][ 715][0][ 0]  [    ][    ][    ][  ][     ][    ]
[131][ 716][0][ 2]  [    ][    ][    ][  ][RIGHT][    ]
[132][ 724][0][18]  [    ][JUMP][    ][  ][RIGHT][    ]
[133][ 734][0][16]  [    ][JUMP][    ][  ][     ][    ]
[134][ 735][0][48]  [FIRE][JUMP][    ][  ][     ][    ]
[135][ 739][0][32]  [FIRE][    ][    ][  ][     ][    ]
[136][ 741][0][33]  [FIRE][    ][    ][  ][     ][LEFT]
[137][ 755][0][32]  [FIRE][    ][    ][  ][     ][    ]
[138][ 757][0][34]  [FIRE][    ][    ][  ][RIGHT][    ]
[139][ 771][0][50]  [FIRE][JUMP][    ][  ][RIGHT][    ]
[140][ 784][0][34]  [FIRE][    ][    ][  ][RIGHT][    ]
[141][ 815][0][32]  [FIRE][    ][    ][  ][     ][    ]
[142][ 817][0][33]  [FIRE][    ][    ][  ][     ][LEFT]
[143][ 824][0][35]  [FIRE][    ][    ][  ][RIGHT][LEFT]
[144][ 825][0][34]  [FIRE][    ][    ][  ][RIGHT][    ]
[145][ 836][0][ 2]  [    ][    ][    ][  ][RIGHT][    ]
[146][ 840][0][ 0]  [    ][    ][    ][  ][     ][    ]
[147][ 844][0][ 1]  [    ][    ][    ][  ][     ][LEFT]
[148][ 855][0][ 0]  [    ][    ][    ][  ][     ][    ]
[149][ 860][0][16]  [    ][JUMP][    ][  ][     ][    ]
[150][ 869][0][18]  [    ][JUMP][    ][  ][RIGHT][    ]
[151][ 870][0][50]  [FIRE][JUMP][    ][  ][RIGHT][    ]
[152][ 871][0][34]  [FIRE][    ][    ][  ][RIGHT][    ]
[153][ 875][0][38]  [FIRE][    ][    ][UP][RIGHT][    ]
[154][ 877][0][ 6]  [    ][    ][    ][UP][RIGHT][    ]
[155][ 883][0][38]  [FIRE][    ][    ][UP][RIGHT][    ]
[156][ 887][0][ 6]  [    ][    ][    ][UP][RIGHT][    ]
[157][ 888][0][ 4]  [    ][    ][    ][UP][     ][    ]
[158][ 891][0][36]  [FIRE][    ][    ][UP][     ][    ]
[159][ 893][0][ 4]  [    ][    ][    ][UP][     ][    ]
[160][ 898][0][36]  [FIRE][    ][    ][UP][     ][    ]
[161][ 900][0][ 4]  [    ][    ][    ][UP][     ][    ]
[162][ 901][0][ 6]  [    ][    ][    ][UP][RIGHT][    ]
[163][ 904][0][ 4]  [    ][    ][    ][UP][     ][    ]
[164][ 905][0][36]  [FIRE][    ][    ][UP][     ][    ]
[165][ 906][0][ 4]  [    ][    ][    ][UP][     ][    ]
[166][ 910][0][36]  [FIRE][    ][    ][UP][     ][    ]
[167][ 912][0][38]  [FIRE][    ][    ][UP][RIGHT][    ]
[168][ 913][0][ 6]  [    ][    ][    ][UP][RIGHT][    ]
[169][ 917][0][38]  [FIRE][    ][    ][UP][RIGHT][    ]
[170][ 919][0][ 6]  [    ][    ][    ][UP][RIGHT][    ]
[171][ 923][0][38]  [FIRE][    ][    ][UP][RIGHT][    ]
[172][ 925][0][ 6]  [    ][    ][    ][UP][RIGHT][    ]
[173][ 929][0][22]  [    ][JUMP][    ][UP][RIGHT][    ]
[174][ 932][0][20]  [    ][JUMP][    ][UP][     ][    ]
[175][ 937][0][52]  [FIRE][JUMP][    ][UP][     ][    ]
[176][ 938][0][36]  [FIRE][    ][    ][UP][     ][    ]
[177][ 940][0][ 4]  [    ][    ][    ][UP][     ][    ]
[178][ 944][0][36]  [FIRE][    ][    ][UP][     ][    ]
[179][ 946][0][ 4]  [    ][    ][    ][UP][     ][    ]
[180][ 949][0][ 5]  [    ][    ][    ][UP][     ][LEFT]
[181][ 951][0][37]  [FIRE][    ][    ][UP][     ][LEFT]
[182][ 954][0][ 4]  [    ][    ][    ][UP][     ][    ]
[183][ 956][0][ 6]  [    ][    ][    ][UP][RIGHT][    ]
[184][ 958][0][38]  [FIRE][    ][    ][UP][RIGHT][    ]
[185][ 960][0][ 6]  [    ][    ][    ][UP][RIGHT][    ]
[186][ 965][0][38]  [FIRE][    ][    ][UP][RIGHT][    ]
[187][ 966][0][36]  [FIRE][    ][    ][UP][     ][    ]
[188][ 967][0][ 4]  [    ][    ][    ][UP][     ][    ]
[189][ 968][0][ 5]  [    ][    ][    ][UP][     ][LEFT]
[190][ 971][0][37]  [FIRE][    ][    ][UP][     ][LEFT]
[191][ 973][0][ 5]  [    ][    ][    ][UP][     ][LEFT]
[192][ 974][0][ 4]  [    ][    ][    ][UP][     ][    ]
[193][ 978][0][38]  [FIRE][    ][    ][UP][RIGHT][    ]
[194][ 980][0][ 6]  [    ][    ][    ][UP][RIGHT][    ]
[195][ 986][0][38]  [FIRE][    ][    ][UP][RIGHT][    ]
[196][ 988][0][54]  [FIRE][JUMP][    ][UP][RIGHT][    ]
[197][ 990][0][22]  [    ][JUMP][    ][UP][RIGHT][    ]
[198][ 991][0][18]  [    ][JUMP][    ][  ][RIGHT][    ]
[199][ 999][0][ 2]  [    ][    ][    ][  ][RIGHT][    ]
[200][1026][0][18]  [    ][JUMP][    ][  ][RIGHT][    ]
[201][1065][0][ 0]  [    ][    ][    ][  ][     ][    ]
[202][1078][0][ 1]  [    ][    ][    ][  ][     ][LEFT]
[203][1086][0][ 0]  [    ][    ][    ][  ][     ][    ]
[204][1091][0][16]  [    ][JUMP][    ][  ][     ][    ]
[205][1097][0][ 0]  [    ][    ][    ][  ][     ][    ]
[206][1106][0][ 1]  [    ][    ][    ][  ][     ][LEFT]
[207][1111][0][ 0]  [    ][    ][    ][  ][     ][    ]
[208][1138][0][16]  [    ][JUMP][    ][  ][     ][    ]
[209][1145][0][17]  [    ][JUMP][    ][  ][     ][LEFT]
[210][1149][0][ 1]  [    ][    ][    ][  ][     ][LEFT]
[211][1150][0][ 0]  [    ][    ][    ][  ][     ][    ]
[212][1152][0][32]  [FIRE][    ][    ][  ][     ][    ]
[213][1154][0][33]  [FIRE][    ][    ][  ][     ][LEFT]
[214][1156][0][ 1]  [    ][    ][    ][  ][     ][LEFT]
[215][1161][0][33]  [FIRE][    ][    ][  ][     ][LEFT]
[216][1163][0][ 1]  [    ][    ][    ][  ][     ][LEFT]
[217][1167][0][33]  [FIRE][    ][    ][  ][     ][LEFT]
[218][1169][0][ 0]  [    ][    ][    ][  ][     ][    ]
[219][1172][0][32]  [FIRE][    ][    ][  ][     ][    ]
[220][1173][0][33]  [FIRE][    ][    ][  ][     ][LEFT]
[221][1177][0][49]  [FIRE][JUMP][    ][  ][     ][LEFT]
[222][1179][0][17]  [    ][JUMP][    ][  ][     ][LEFT]
[223][1183][0][ 1]  [    ][    ][    ][  ][     ][LEFT]
[224][1184][0][33]  [FIRE][    ][    ][  ][     ][LEFT]
[225][1185][0][ 1]  [    ][    ][    ][  ][     ][LEFT]
[226][1190][0][ 3]  [    ][    ][    ][  ][RIGHT][LEFT]
[227][1191][0][ 2]  [    ][    ][    ][  ][RIGHT][    ]
[228][1212][0][18]  [    ][JUMP][    ][  ][RIGHT][    ]
[229][1237][0][ 2]  [    ][    ][    ][  ][RIGHT][    ]
[230][1241][0][ 0]  [    ][    ][    ][  ][     ][    ]
[231][1242][0][ 1]  [    ][    ][    ][  ][     ][LEFT]
[232][1246][0][ 0]  [    ][    ][    ][  ][     ][    ]
[233][1249][0][ 2]  [    ][    ][    ][  ][RIGHT][    ]
[234][1253][0][ 0]  [    ][    ][    ][  ][     ][    ]
[235][1254][0][ 1]  [    ][    ][    ][  ][     ][LEFT]
[236][1256][0][ 0]  [    ][    ][    ][  ][     ][    ]
[237][1262][0][18]  [    ][JUMP][    ][  ][RIGHT][    ]
[238][1264][0][16]  [    ][JUMP][    ][  ][     ][    ]
[239][1267][0][17]  [    ][JUMP][    ][  ][     ][LEFT]
[240][1274][0][16]  [    ][JUMP][    ][  ][     ][    ]
[241][1275][0][17]  [    ][JUMP][    ][  ][     ][LEFT]
[242][1281][0][ 1]  [    ][    ][    ][  ][     ][LEFT]
[243][1282][0][ 0]  [    ][    ][    ][  ][     ][    ]
[244][1289][0][ 2]  [    ][    ][    ][  ][RIGHT][    ]
[245][1297]-------------LEVEL DONE 1 ---------------- 
[246][1377]-------------LEVEL DONE 2 ---------------- 
[247][2097]-------------NEXT LEVEL!------------------ 
[248][1415]-------------PLAYER 0 ACKNOWLEDGE------ 
[249][1416]-------------NEXT LEVEL!------------------ 
