number of entries 55
deathmatch_pbullets 1
deathmatch_pbullets_damage 5
suicide_pbullets 1
[ gm][  pc][p][cm]
[  0][   0]-------------START (level:42)------------- 
[  1][   0]-------------PLAYER 0 ACTIVE (color:8)-- 
[  2][  28][0][ 1]  [    ][    ][    ][  ][     ][LEFT]
[  3][  33][0][ 3]  [    ][    ][    ][  ][RIGHT][LEFT]
[  4][  36][0][ 2]  [    ][    ][    ][  ][RIGHT][    ]
[  5][  41][0][18]  [    ][JUMP][    ][  ][RIGHT][    ]
[  6][  44][0][16]  [    ][JUMP][    ][  ][     ][    ]
[  7][  46][0][48]  [FIRE][JUMP][    ][  ][     ][    ]
[  8][  49][0][32]  [FIRE][    ][    ][  ][     ][    ]
[  9][  50][0][ 0]  [    ][    ][    ][  ][     ][    ]
[ 10][  54][0][16]  [    ][JUMP][    ][  ][     ][    ]
[ 11][  55][0][48]  [FIRE][JUMP][    ][  ][     ][    ]
[ 12][  58][0][ 0]  [    ][    ][    ][  ][     ][    ]
[ 13][  62][0][48]  [FIRE][JUMP][    ][  ][     ][    ]
[ 14][  63][0][50]  [FIRE][JUMP][    ][  ][RIGHT][    ]
[ 15][  64][0][ 2]  [    ][    ][    ][  ][RIGHT][    ]
[ 16][  68][0][50]  [FIRE][JUMP][    ][  ][RIGHT][    ]
[ 17][  70][0][ 2]  [    ][    ][    ][  ][RIGHT][    ]
[ 18][  73][0][ 0]  [    ][    ][    ][  ][     ][    ]
[ 19][  74][0][32]  [FIRE][    ][    ][  ][     ][    ]
[ 20][  75][0][48]  [FIRE][JUMP][    ][  ][     ][    ]
[ 21][  76][0][ 0]  [    ][    ][    ][  ][     ][    ]
[ 22][  80][0][32]  [FIRE][    ][    ][  ][     ][    ]
[ 23][  81][0][ 0]  [    ][    ][    ][  ][     ][    ]
[ 24][  86][0][48]  [FIRE][JUMP][    ][  ][     ][    ]
[ 25][  87][0][16]  [    ][JUMP][    ][  ][     ][    ]
[ 26][  88][0][ 0]  [    ][    ][    ][  ][     ][    ]
[ 27][  92][0][48]  [FIRE][JUMP][    ][  ][     ][    ]
[ 28][  94][0][ 0]  [    ][    ][    ][  ][     ][    ]
[ 29][  98][0][32]  [FIRE][    ][    ][  ][     ][    ]
[ 30][  99][0][48]  [FIRE][JUMP][    ][  ][     ][    ]
[ 31][ 101][0][ 0]  [    ][    ][    ][  ][     ][    ]
[ 32][ 102][0][ 2]  [    ][    ][    ][  ][RIGHT][    ]
[ 33][ 118][0][18]  [    ][JUMP][    ][  ][RIGHT][    ]
[ 34][ 120][0][16]  [    ][JUMP][    ][  ][     ][    ]
[ 35][ 135][0][ 0]  [    ][    ][    ][  ][     ][    ]
[ 36][ 138][0][ 2]  [    ][    ][    ][  ][RIGHT][    ]
[ 37][ 174][0][ 3]  [    ][    ][    ][  ][RIGHT][LEFT]
[ 38][ 175][0][ 1]  [    ][    ][    ][  ][     ][LEFT]
[ 39][ 188][0][ 0]  [    ][    ][    ][  ][     ][    ]
[ 40][ 193][0][16]  [    ][JUMP][    ][  ][     ][    ]
[ 41][ 201][0][ 0]  [    ][    ][    ][  ][     ][    ]
[ 42][ 203][0][ 2]  [    ][    ][    ][  ][RIGHT][    ]
[ 43][ 206][0][ 0]  [    ][    ][    ][  ][     ][    ]
[ 44][ 210][0][ 1]  [    ][    ][    ][  ][     ][LEFT]
[ 45][ 214][0][ 0]  [    ][    ][    ][  ][     ][    ]
[ 46][ 223][0][ 2]  [    ][    ][    ][  ][RIGHT][    ]
[ 47][ 245][0][ 0]  [    ][    ][    ][  ][     ][    ]
[ 48][ 249][0][16]  [    ][JUMP][    ][  ][     ][    ]
[ 49][ 256][0][18]  [    ][JUMP][    ][  ][RIGHT][    ]
[ 50][ 261]-------------LEVEL DONE 1 ---------------- 
[ 51][ 341]-------------LEVEL DONE 2 ---------------- 
[ 52][1061]-------------NEXT LEVEL!------------------ 
[ 53][ 343]-------------PLAYER 0 ACKNOWLEDGE------ 
[ 54][ 344]-------------NEXT LEVEL!------------------ 
