number of entries 244
deathmatch_pbullets 1
deathmatch_pbullets_damage 5
suicide_pbullets 1
[ gm][  pc][p][cm]
[  0][   0]-------------START (level:381)------------- 
[  1][   0]-------------PLAYER 0 ACTIVE (color:9)-- 
[  2][  48][0][ 1]  [    ][    ][    ][  ][     ][LEFT]
[  3][  53][0][ 3]  [    ][    ][    ][  ][RIGHT][LEFT]
[  4][  57][0][ 1]  [    ][    ][    ][  ][     ][LEFT]
[  5][  60][0][ 5]  [    ][    ][    ][UP][     ][LEFT]
[  6][  62][0][22]  [    ][JUMP][    ][UP][RIGHT][    ]
[  7][  64][0][54]  [FIRE][JUMP][    ][UP][RIGHT][    ]
[  8][  66][0][39]  [FIRE][    ][    ][UP][RIGHT][LEFT]
[  9][  68][0][ 1]  [    ][    ][    ][  ][     ][LEFT]
[ 10][  70][0][17]  [    ][JUMP][    ][  ][     ][LEFT]
[ 11][  71][0][21]  [    ][JUMP][    ][UP][     ][LEFT]
[ 12][  73][0][36]  [FIRE][    ][    ][UP][     ][    ]
[ 13][  76][0][37]  [FIRE][    ][    ][UP][     ][LEFT]
[ 14][  78][0][49]  [FIRE][JUMP][    ][  ][     ][LEFT]
[ 15][  79][0][17]  [    ][JUMP][    ][  ][     ][LEFT]
[ 16][  82][0][23]  [    ][JUMP][    ][UP][RIGHT][LEFT]
[ 17][  84][0][38]  [FIRE][    ][    ][UP][RIGHT][    ]
[ 18][  86][0][33]  [FIRE][    ][    ][  ][     ][LEFT]
[ 19][  87][0][ 1]  [    ][    ][    ][  ][     ][LEFT]
[ 20][  96][0][ 0]  [    ][    ][    ][  ][     ][    ]
[ 21][ 100][0][ 2]  [    ][    ][    ][  ][RIGHT][    ]
[ 22][ 104][0][ 0]  [    ][    ][    ][  ][     ][    ]
[ 23][ 109][0][ 1]  [    ][    ][    ][  ][     ][LEFT]
[ 24][ 111][0][ 0]  [    ][    ][    ][  ][     ][    ]
[ 25][ 122][0][16]  [    ][JUMP][    ][  ][     ][    ]
[ 26][ 168][0][18]  [    ][JUMP][    ][  ][RIGHT][    ]
[ 27][ 181][0][ 2]  [    ][    ][    ][  ][RIGHT][    ]
[ 28][ 197][0][ 0]  [    ][    ][    ][  ][     ][    ]
[ 29][ 216][0][ 1]  [    ][    ][    ][  ][     ][LEFT]
[ 30][ 218][0][ 0]  [    ][    ][    ][  ][     ][    ]
[ 31][ 220][0][16]  [    ][JUMP][    ][  ][     ][    ]
[ 32][ 251][0][17]  [    ][JUMP][    ][  ][     ][LEFT]
[ 33][ 271][0][16]  [    ][JUMP][    ][  ][     ][    ]
[ 34][ 325][0][17]  [    ][JUMP][    ][  ][     ][LEFT]
[ 35][ 329][0][ 1]  [    ][    ][    ][  ][     ][LEFT]
[ 36][ 332][0][ 0]  [    ][    ][    ][  ][     ][    ]
[ 37][ 336][0][ 1]  [    ][    ][    ][  ][     ][LEFT]
[ 38][ 340][0][ 0]  [    ][    ][    ][  ][     ][    ]
[ 39][ 341][0][16]  [    ][JUMP][    ][  ][     ][    ]
[ 40][ 349][0][17]  [    ][JUMP][    ][  ][     ][LEFT]
[ 41][ 352][0][16]  [    ][JUMP][    ][  ][     ][    ]
[ 42][ 387][0][ 0]  [    ][    ][    ][  ][     ][    ]
[ 43][ 407][0][16]  [    ][JUMP][    ][  ][     ][    ]
[ 44][ 433][0][18]  [    ][JUMP][    ][  ][RIGHT][    ]
[ 45][ 449][0][ 2]  [    ][    ][    ][  ][RIGHT][    ]
[ 46][ 457][0][ 0]  [    ][    ][    ][  ][     ][    ]
[ 47][ 469][0][ 2]  [    ][    ][    ][  ][RIGHT][    ]
[ 48][ 472][0][ 0]  [    ][    ][    ][  ][     ][    ]
[ 49][ 482][0][ 1]  [    ][    ][    ][  ][     ][LEFT]
[ 50][ 484][0][32]  [FIRE][    ][    ][  ][     ][    ]
[ 51][ 505][0][34]  [FIRE][    ][    ][  ][RIGHT][    ]
[ 52][ 508][0][32]  [FIRE][    ][    ][  ][     ][    ]
[ 53][ 515][0][34]  [FIRE][    ][    ][  ][RIGHT][    ]
[ 54][ 522][0][32]  [FIRE][    ][    ][  ][     ][    ]
[ 55][ 530][0][34]  [FIRE][    ][    ][  ][RIGHT][    ]
[ 56][ 536][0][32]  [FIRE][    ][    ][  ][     ][    ]
[ 57][ 619][0][34]  [FIRE][    ][    ][  ][RIGHT][    ]
[ 58][ 657][0][32]  [FIRE][    ][    ][  ][     ][    ]
[ 59][ 675][0][33]  [FIRE][    ][    ][  ][     ][LEFT]
[ 60][ 678][0][32]  [FIRE][    ][    ][  ][     ][    ]
[ 61][ 698][0][34]  [FIRE][    ][    ][  ][RIGHT][    ]
[ 62][ 700][0][32]  [FIRE][    ][    ][  ][     ][    ]
[ 63][ 726][0][33]  [FIRE][    ][    ][  ][     ][LEFT]
[ 64][ 730][0][32]  [FIRE][    ][    ][  ][     ][    ]
[ 65][ 747][0][34]  [FIRE][    ][    ][  ][RIGHT][    ]
[ 66][ 751][0][32]  [FIRE][    ][    ][  ][     ][    ]
[ 67][ 779][0][34]  [FIRE][    ][    ][  ][RIGHT][    ]
[ 68][ 784][0][32]  [FIRE][    ][    ][  ][     ][    ]
[ 69][ 834][0][34]  [FIRE][    ][    ][  ][RIGHT][    ]
[ 70][ 880][0][32]  [FIRE][    ][    ][  ][     ][    ]
[ 71][ 891][0][34]  [FIRE][    ][    ][  ][RIGHT][    ]
[ 72][ 900][0][32]  [FIRE][    ][    ][  ][     ][    ]
[ 73][ 919][0][33]  [FIRE][    ][    ][  ][     ][LEFT]
[ 74][ 922][0][32]  [FIRE][    ][    ][  ][     ][    ]
[ 75][ 943][0][33]  [FIRE][    ][    ][  ][     ][LEFT]
[ 76][ 944][0][32]  [FIRE][    ][    ][  ][     ][    ]
[ 77][ 966][0][33]  [FIRE][    ][    ][  ][     ][LEFT]
[ 78][ 968][0][32]  [FIRE][    ][    ][  ][     ][    ]
[ 79][1037][0][33]  [FIRE][    ][    ][  ][     ][LEFT]
[ 80][1041][0][ 1]  [    ][    ][    ][  ][     ][LEFT]
[ 81][1088][0][33]  [FIRE][    ][    ][  ][     ][LEFT]
[ 82][1091][0][ 1]  [    ][    ][    ][  ][     ][LEFT]
[ 83][1093][0][ 5]  [    ][    ][    ][UP][     ][LEFT]
[ 84][1095][0][ 4]  [    ][    ][    ][UP][     ][    ]
[ 85][1096][0][36]  [FIRE][    ][    ][UP][     ][    ]
[ 86][1097][0][38]  [FIRE][    ][    ][UP][RIGHT][    ]
[ 87][1098][0][ 6]  [    ][    ][    ][UP][RIGHT][    ]
[ 88][1104][0][38]  [FIRE][    ][    ][UP][RIGHT][    ]
[ 89][1106][0][ 6]  [    ][    ][    ][UP][RIGHT][    ]
[ 90][1110][0][38]  [FIRE][    ][    ][UP][RIGHT][    ]
[ 91][1113][0][ 6]  [    ][    ][    ][UP][RIGHT][    ]
[ 92][1114][0][ 4]  [    ][    ][    ][UP][     ][    ]
[ 93][1117][0][36]  [FIRE][    ][    ][UP][     ][    ]
[ 94][1118][0][ 4]  [    ][    ][    ][UP][     ][    ]
[ 95][1123][0][36]  [FIRE][    ][    ][UP][     ][    ]
[ 96][1124][0][38]  [FIRE][    ][    ][UP][RIGHT][    ]
[ 97][1126][0][ 6]  [    ][    ][    ][UP][RIGHT][    ]
[ 98][1130][0][36]  [FIRE][    ][    ][UP][     ][    ]
[ 99][1132][0][ 4]  [    ][    ][    ][UP][     ][    ]
[100][1134][0][ 5]  [    ][    ][    ][UP][     ][LEFT]
[101][1137][0][37]  [FIRE][    ][    ][UP][     ][LEFT]
[102][1139][0][ 5]  [    ][    ][    ][UP][     ][LEFT]
[103][1141][0][ 4]  [    ][    ][    ][UP][     ][    ]
[104][1143][0][36]  [FIRE][    ][    ][UP][     ][    ]
[105][1145][0][ 4]  [    ][    ][    ][UP][     ][    ]
[106][1149][0][36]  [FIRE][    ][    ][UP][     ][    ]
[107][1150][0][38]  [FIRE][    ][    ][UP][RIGHT][    ]
[108][1152][0][ 6]  [    ][    ][    ][UP][RIGHT][    ]
[109][1157][0][36]  [FIRE][    ][    ][UP][     ][    ]
[110][1158][0][ 4]  [    ][    ][    ][UP][     ][    ]
[111][1162][0][36]  [FIRE][    ][    ][UP][     ][    ]
[112][1165][0][ 4]  [    ][    ][    ][UP][     ][    ]
[113][1167][0][ 6]  [    ][    ][    ][UP][RIGHT][    ]
[114][1170][0][38]  [FIRE][    ][    ][UP][RIGHT][    ]
[115][1172][0][ 6]  [    ][    ][    ][UP][RIGHT][    ]
[116][1173][0][ 4]  [    ][    ][    ][UP][     ][    ]
[117][1174][0][ 5]  [    ][    ][    ][UP][     ][LEFT]
[118][1177][0][37]  [FIRE][    ][    ][UP][     ][LEFT]
[119][1179][0][ 5]  [    ][    ][    ][UP][     ][LEFT]
[120][1181][0][ 6]  [    ][    ][    ][UP][RIGHT][    ]
[121][1183][0][38]  [FIRE][    ][    ][UP][RIGHT][    ]
[122][1186][0][ 6]  [    ][    ][    ][UP][RIGHT][    ]
[123][1187][0][ 5]  [    ][    ][    ][UP][     ][LEFT]
[124][1188][0][ 1]  [    ][    ][    ][  ][     ][LEFT]
[125][1190][0][33]  [FIRE][    ][    ][  ][     ][LEFT]
[126][1192][0][ 1]  [    ][    ][    ][  ][     ][LEFT]
[127][1217][0][17]  [    ][JUMP][    ][  ][     ][LEFT]
[128][1218][0][16]  [    ][JUMP][    ][  ][     ][    ]
[129][1233][0][18]  [    ][JUMP][    ][  ][RIGHT][    ]
[130][1244][0][16]  [    ][JUMP][    ][  ][     ][    ]
[131][1249][0][ 0]  [    ][    ][    ][  ][     ][    ]
[132][1262][0][ 1]  [    ][    ][    ][  ][     ][LEFT]
[133][1270][0][ 0]  [    ][    ][    ][  ][     ][    ]
[134][1273][0][16]  [    ][JUMP][    ][  ][     ][    ]
[135][1283][0][20]  [    ][JUMP][    ][UP][     ][    ]
[136][1298][0][ 4]  [    ][    ][    ][UP][     ][    ]
[137][1309][0][ 0]  [    ][    ][    ][  ][     ][    ]
[138][1324][0][ 1]  [    ][    ][    ][  ][     ][LEFT]
[139][1345][0][ 0]  [    ][    ][    ][  ][     ][    ]
[140][1354][0][ 1]  [    ][    ][    ][  ][     ][LEFT]
[141][1360][0][ 5]  [    ][    ][    ][UP][     ][LEFT]
[142][1362][0][37]  [FIRE][    ][    ][UP][     ][LEFT]
[143][1366][0][36]  [FIRE][    ][    ][UP][     ][    ]
[144][1367][0][ 4]  [    ][    ][    ][UP][     ][    ]
[145][1370][0][36]  [FIRE][    ][    ][UP][     ][    ]
[146][1374][0][ 4]  [    ][    ][    ][UP][     ][    ]
[147][1378][0][37]  [FIRE][    ][    ][UP][     ][LEFT]
[148][1381][0][ 5]  [    ][    ][    ][UP][     ][LEFT]
[149][1384][0][ 4]  [    ][    ][    ][UP][     ][    ]
[150][1386][0][38]  [FIRE][    ][    ][UP][RIGHT][    ]
[151][1389][0][ 6]  [    ][    ][    ][UP][RIGHT][    ]
[152][1393][0][ 4]  [    ][    ][    ][UP][     ][    ]
[153][1394][0][ 1]  [    ][    ][    ][  ][     ][LEFT]
[154][1397][0][ 0]  [    ][    ][    ][  ][     ][    ]
[155][1399][0][ 2]  [    ][    ][    ][  ][RIGHT][    ]
[156][1403][0][ 3]  [    ][    ][    ][  ][RIGHT][LEFT]
[157][1404][0][ 1]  [    ][    ][    ][  ][     ][LEFT]
[158][1407][0][ 0]  [    ][    ][    ][  ][     ][    ]
[159][1408][0][ 2]  [    ][    ][    ][  ][RIGHT][    ]
[160][1412][0][ 1]  [    ][    ][    ][  ][     ][LEFT]
[161][1415][0][ 0]  [    ][    ][    ][  ][     ][    ]
[162][1417][0][ 2]  [    ][    ][    ][  ][RIGHT][    ]
[163][1419][0][ 0]  [    ][    ][    ][  ][     ][    ]
[164][1420][0][ 1]  [    ][    ][    ][  ][     ][LEFT]
[165][1424][0][ 0]  [    ][    ][    ][  ][     ][    ]
[166][1428][0][ 1]  [    ][    ][    ][  ][     ][LEFT]
[167][1431][0][ 0]  [    ][    ][    ][  ][     ][    ]
[168][1436][0][ 1]  [    ][    ][    ][  ][     ][LEFT]
[169][1438][0][ 0]  [    ][    ][    ][  ][     ][    ]
[170][1443][0][ 1]  [    ][    ][    ][  ][     ][LEFT]
[171][1445][0][ 0]  [    ][    ][    ][  ][     ][    ]
[172][1450][0][16]  [    ][JUMP][    ][  ][     ][    ]
[173][1507][0][18]  [    ][JUMP][    ][  ][RIGHT][    ]
[174][1532][0][ 2]  [    ][    ][    ][  ][RIGHT][    ]
[175][1546][0][ 0]  [    ][    ][    ][  ][     ][    ]
[176][1553][0][ 1]  [    ][    ][    ][  ][     ][LEFT]
[177][1555][0][ 0]  [    ][    ][    ][  ][     ][    ]
[178][1561][0][ 1]  [    ][    ][    ][  ][     ][LEFT]
[179][1563][0][ 0]  [    ][    ][    ][  ][     ][    ]
[180][1567][0][ 1]  [    ][    ][    ][  ][     ][LEFT]
[181][1570][0][ 0]  [    ][    ][    ][  ][     ][    ]
[182][1574][0][ 1]  [    ][    ][    ][  ][     ][LEFT]
[183][1577][0][16]  [    ][JUMP][    ][  ][     ][    ]
[184][1610][0][17]  [    ][JUMP][    ][  ][     ][LEFT]
[185][1634][0][ 0]  [    ][    ][    ][  ][     ][    ]
[186][1639][0][ 1]  [    ][    ][    ][  ][     ][LEFT]
[187][1642][0][ 0]  [    ][    ][    ][  ][     ][    ]
[188][1647][0][ 1]  [    ][    ][    ][  ][     ][LEFT]
[189][1650][0][ 0]  [    ][    ][    ][  ][     ][    ]
[190][1655][0][ 1]  [    ][    ][    ][  ][     ][LEFT]
[191][1657][0][ 0]  [    ][    ][    ][  ][     ][    ]
[192][1661][0][16]  [    ][JUMP][    ][  ][     ][    ]
[193][1666][0][18]  [    ][JUMP][    ][  ][RIGHT][    ]
[194][1669][0][16]  [    ][JUMP][    ][  ][     ][    ]
[195][1733][0][18]  [    ][JUMP][    ][  ][RIGHT][    ]
[196][1762][0][16]  [    ][JUMP][    ][  ][     ][    ]
[197][1770][0][ 0]  [    ][    ][    ][  ][     ][    ]
[198][1784][0][ 2]  [    ][    ][    ][  ][RIGHT][    ]
[199][1786][0][ 0]  [    ][    ][    ][  ][     ][    ]
[200][1791][0][ 1]  [    ][    ][    ][  ][     ][LEFT]
[201][1794][0][ 0]  [    ][    ][    ][  ][     ][    ]
[202][1796][0][16]  [    ][JUMP][    ][  ][     ][    ]
[203][1826][0][17]  [    ][JUMP][    ][  ][     ][LEFT]
[204][1829][0][48]  [FIRE][JUMP][    ][  ][     ][    ]
[205][1831][0][32]  [FIRE][    ][    ][  ][     ][    ]
[206][1850][0][33]  [FIRE][    ][    ][  ][     ][LEFT]
[207][1863][0][32]  [FIRE][    ][    ][  ][     ][    ]
[208][1936][0][33]  [FIRE][    ][    ][  ][     ][LEFT]
[209][1939][0][32]  [FIRE][    ][    ][  ][     ][    ]
[210][1945][0][33]  [FIRE][    ][    ][  ][     ][LEFT]
[211][1947][0][32]  [FIRE][    ][    ][  ][     ][    ]
[212][1960][0][33]  [FIRE][    ][    ][  ][     ][LEFT]
[213][1963][0][32]  [FIRE][    ][    ][  ][     ][    ]
[214][1968][0][33]  [FIRE][    ][    ][  ][     ][LEFT]
[215][1986][0][32]  [FIRE][    ][    ][  ][     ][    ]
[216][2002][0][33]  [FIRE][    ][    ][  ][     ][LEFT]
[217][2006][0][32]  [FIRE][    ][    ][  ][     ][    ]
[218][2011][0][33]  [FIRE][    ][    ][  ][     ][LEFT]
[219][2014][0][32]  [FIRE][    ][    ][  ][     ][    ]
[220][2025][0][33]  [FIRE][    ][    ][  ][     ][LEFT]
[221][2029][0][32]  [FIRE][    ][    ][  ][     ][    ]
[222][2037][0][33]  [FIRE][    ][    ][  ][     ][LEFT]
[223][2041][0][32]  [FIRE][    ][    ][  ][     ][    ]
[224][2205][0][33]  [FIRE][    ][    ][  ][     ][LEFT]
[225][2255][0][32]  [FIRE][    ][    ][  ][     ][    ]
[226][2267][0][33]  [FIRE][    ][    ][  ][     ][LEFT]
[227][2270][0][32]  [FIRE][    ][    ][  ][     ][    ]
[228][2276][0][33]  [FIRE][    ][    ][  ][     ][LEFT]
[229][2278][0][32]  [FIRE][    ][    ][  ][     ][    ]
[230][2338][0][34]  [FIRE][    ][    ][  ][RIGHT][    ]
[231][2340][0][32]  [FIRE][    ][    ][  ][     ][    ]
[232][2411][0][34]  [FIRE][    ][    ][  ][RIGHT][    ]
[233][2428][0][32]  [FIRE][    ][    ][  ][     ][    ]
[234][2434][0][33]  [FIRE][    ][    ][  ][     ][LEFT]
[235][2474][0][32]  [FIRE][    ][    ][  ][     ][    ]
[236][2477][0][34]  [FIRE][    ][    ][  ][RIGHT][    ]
[237][2510][0][ 2]  [    ][    ][    ][  ][RIGHT][    ]
[238][2522][0][ 0]  [    ][    ][    ][  ][     ][    ]
[239][2529][0][ 2]  [    ][    ][    ][  ][RIGHT][    ]
[240][2539][0][ 0]  [    ][    ][    ][  ][     ][    ]
[241][2666][0][ 2]  [    ][    ][    ][  ][RIGHT][    ]
[242][2677][0][ 0]  [    ][    ][    ][  ][     ][    ]
[243][2679]-------------LEVEL DONE!------------------ 
