number of entries 133
deathmatch_pbullets 0
deathmatch_pbullets_damage 5
suicide_pbullets 0
[ gm][  pc][p][cm]
[  0][   0]-------------START (level:40)------------- 
[  1][   0]-------------PLAYER 0 ACTIVE (color:8)-- 
[  2][  33][0][ 2]  [    ][    ][    ][  ][RIGHT][    ]
[  3][  55][0][16]  [    ][JUMP][    ][  ][     ][    ]
[  4][  65][0][ 0]  [    ][    ][    ][  ][     ][    ]
[  5][  70][0][ 2]  [    ][    ][    ][  ][RIGHT][    ]
[  6][ 100][0][18]  [    ][JUMP][    ][  ][RIGHT][    ]
[  7][ 116][0][ 2]  [    ][    ][    ][  ][RIGHT][    ]
[  8][ 129][0][ 3]  [    ][    ][    ][  ][RIGHT][LEFT]
[  9][ 130][0][ 1]  [    ][    ][    ][  ][     ][LEFT]
[ 10][ 133][0][33]  [FIRE][    ][    ][  ][     ][LEFT]
[ 11][ 136][0][ 0]  [    ][    ][    ][  ][     ][    ]
[ 12][ 141][0][32]  [FIRE][    ][    ][  ][     ][    ]
[ 13][ 143][0][ 0]  [    ][    ][    ][  ][     ][    ]
[ 14][ 147][0][32]  [FIRE][    ][    ][  ][     ][    ]
[ 15][ 150][0][ 0]  [    ][    ][    ][  ][     ][    ]
[ 16][ 152][0][16]  [    ][JUMP][    ][  ][     ][    ]
[ 17][ 155][0][48]  [FIRE][JUMP][    ][  ][     ][    ]
[ 18][ 156][0][ 0]  [    ][    ][    ][  ][     ][    ]
[ 19][ 160][0][32]  [FIRE][    ][    ][  ][     ][    ]
[ 20][ 161][0][48]  [FIRE][JUMP][    ][  ][     ][    ]
[ 21][ 163][0][32]  [FIRE][    ][    ][  ][     ][    ]
[ 22][ 164][0][ 0]  [    ][    ][    ][  ][     ][    ]
[ 23][ 167][0][32]  [FIRE][    ][    ][  ][     ][    ]
[ 24][ 168][0][48]  [FIRE][JUMP][    ][  ][     ][    ]
[ 25][ 170][0][ 0]  [    ][    ][    ][  ][     ][    ]
[ 26][ 173][0][32]  [FIRE][    ][    ][  ][     ][    ]
[ 27][ 174][0][48]  [FIRE][JUMP][    ][  ][     ][    ]
[ 28][ 176][0][ 0]  [    ][    ][    ][  ][     ][    ]
[ 29][ 179][0][32]  [FIRE][    ][    ][  ][     ][    ]
[ 30][ 181][0][ 0]  [    ][    ][    ][  ][     ][    ]
[ 31][ 185][0][32]  [FIRE][    ][    ][  ][     ][    ]
[ 32][ 186][0][48]  [FIRE][JUMP][    ][  ][     ][    ]
[ 33][ 189][0][32]  [FIRE][    ][    ][  ][     ][    ]
[ 34][ 190][0][ 0]  [    ][    ][    ][  ][     ][    ]
[ 35][ 195][0][32]  [FIRE][    ][    ][  ][     ][    ]
[ 36][ 198][0][ 0]  [    ][    ][    ][  ][     ][    ]
[ 37][ 206][0][ 2]  [    ][    ][    ][  ][RIGHT][    ]
[ 38][ 269][0][ 6]  [    ][    ][    ][UP][RIGHT][    ]
[ 39][ 273][0][ 4]  [    ][    ][    ][UP][     ][    ]
[ 40][ 277][0][36]  [FIRE][    ][    ][UP][     ][    ]
[ 41][ 279][0][ 4]  [    ][    ][    ][UP][     ][    ]
[ 42][ 284][0][36]  [FIRE][    ][    ][UP][     ][    ]
[ 43][ 286][0][ 4]  [    ][    ][    ][UP][     ][    ]
[ 44][ 291][0][36]  [FIRE][    ][    ][UP][     ][    ]
[ 45][ 293][0][37]  [FIRE][    ][    ][UP][     ][LEFT]
[ 46][ 294][0][ 5]  [    ][    ][    ][UP][     ][LEFT]
[ 47][ 298][0][ 1]  [    ][    ][    ][  ][     ][LEFT]
[ 48][ 299][0][ 0]  [    ][    ][    ][  ][     ][    ]
[ 49][ 300][0][16]  [    ][JUMP][    ][  ][     ][    ]
[ 50][ 309][0][18]  [    ][JUMP][    ][  ][RIGHT][    ]
[ 51][ 335][0][ 2]  [    ][    ][    ][  ][RIGHT][    ]
[ 52][ 347][0][ 0]  [    ][    ][    ][  ][     ][    ]
[ 53][ 348][0][ 1]  [    ][    ][    ][  ][     ][LEFT]
[ 54][ 357][0][ 0]  [    ][    ][    ][  ][     ][    ]
[ 55][ 364][0][16]  [    ][JUMP][    ][  ][     ][    ]
[ 56][ 373][0][48]  [FIRE][JUMP][    ][  ][     ][    ]
[ 57][ 374][0][32]  [FIRE][    ][    ][  ][     ][    ]
[ 58][ 376][0][ 0]  [    ][    ][    ][  ][     ][    ]
[ 59][ 380][0][32]  [FIRE][    ][    ][  ][     ][    ]
[ 60][ 383][0][ 0]  [    ][    ][    ][  ][     ][    ]
[ 61][ 386][0][32]  [FIRE][    ][    ][  ][     ][    ]
[ 62][ 389][0][ 0]  [    ][    ][    ][  ][     ][    ]
[ 63][ 393][0][32]  [FIRE][    ][    ][  ][     ][    ]
[ 64][ 397][0][ 0]  [    ][    ][    ][  ][     ][    ]
[ 65][ 400][0][ 1]  [    ][    ][    ][  ][     ][LEFT]
[ 66][ 405][0][17]  [    ][JUMP][    ][  ][     ][LEFT]
[ 67][ 411][0][ 0]  [    ][    ][    ][  ][     ][    ]
[ 68][ 424][0][ 1]  [    ][    ][    ][  ][     ][LEFT]
[ 69][ 458][0][17]  [    ][JUMP][    ][  ][     ][LEFT]
[ 70][ 468][0][ 1]  [    ][    ][    ][  ][     ][LEFT]
[ 71][ 488][0][17]  [    ][JUMP][    ][  ][     ][LEFT]
[ 72][ 500][0][ 1]  [    ][    ][    ][  ][     ][LEFT]
[ 73][ 502][0][ 5]  [    ][    ][    ][UP][     ][LEFT]
[ 74][ 504][0][37]  [FIRE][    ][    ][UP][     ][LEFT]
[ 75][ 507][0][36]  [FIRE][    ][    ][UP][     ][    ]
[ 76][ 508][0][ 4]  [    ][    ][    ][UP][     ][    ]
[ 77][ 512][0][ 6]  [    ][    ][    ][UP][RIGHT][    ]
[ 78][ 513][0][38]  [FIRE][    ][    ][UP][RIGHT][    ]
[ 79][ 515][0][ 4]  [    ][    ][    ][UP][     ][    ]
[ 80][ 519][0][ 5]  [    ][    ][    ][UP][     ][LEFT]
[ 81][ 520][0][37]  [FIRE][    ][    ][UP][     ][LEFT]
[ 82][ 522][0][ 5]  [    ][    ][    ][UP][     ][LEFT]
[ 83][ 526][0][37]  [FIRE][    ][    ][UP][     ][LEFT]
[ 84][ 528][0][ 5]  [    ][    ][    ][UP][     ][LEFT]
[ 85][ 533][0][37]  [FIRE][    ][    ][UP][     ][LEFT]
[ 86][ 534][0][36]  [FIRE][    ][    ][UP][     ][    ]
[ 87][ 535][0][ 4]  [    ][    ][    ][UP][     ][    ]
[ 88][ 536][0][ 6]  [    ][    ][    ][UP][RIGHT][    ]
[ 89][ 539][0][38]  [FIRE][    ][    ][UP][RIGHT][    ]
[ 90][ 541][0][ 6]  [    ][    ][    ][UP][RIGHT][    ]
[ 91][ 546][0][38]  [FIRE][    ][    ][UP][RIGHT][    ]
[ 92][ 549][0][ 6]  [    ][    ][    ][UP][RIGHT][    ]
[ 93][ 552][0][ 4]  [    ][    ][    ][UP][     ][    ]
[ 94][ 553][0][36]  [FIRE][    ][    ][UP][     ][    ]
[ 95][ 556][0][ 4]  [    ][    ][    ][UP][     ][    ]
[ 96][ 558][0][ 5]  [    ][    ][    ][UP][     ][LEFT]
[ 97][ 560][0][37]  [FIRE][    ][    ][UP][     ][LEFT]
[ 98][ 563][0][ 4]  [    ][    ][    ][UP][     ][    ]
[ 99][ 567][0][36]  [FIRE][    ][    ][UP][     ][    ]
[100][ 570][0][ 4]  [    ][    ][    ][UP][     ][    ]
[101][ 572][0][ 5]  [    ][    ][    ][UP][     ][LEFT]
[102][ 574][0][37]  [FIRE][    ][    ][UP][     ][LEFT]
[103][ 577][0][ 5]  [    ][    ][    ][UP][     ][LEFT]
[104][ 578][0][ 4]  [    ][    ][    ][UP][     ][    ]
[105][ 581][0][36]  [FIRE][    ][    ][UP][     ][    ]
[106][ 583][0][37]  [FIRE][    ][    ][UP][     ][LEFT]
[107][ 584][0][ 5]  [    ][    ][    ][UP][     ][LEFT]
[108][ 589][0][37]  [FIRE][    ][    ][UP][     ][LEFT]
[109][ 591][0][ 5]  [    ][    ][    ][UP][     ][LEFT]
[110][ 595][0][36]  [FIRE][    ][    ][UP][     ][    ]
[111][ 597][0][ 4]  [    ][    ][    ][UP][     ][    ]
[112][ 598][0][ 5]  [    ][    ][    ][UP][     ][LEFT]
[113][ 602][0][36]  [FIRE][    ][    ][UP][     ][    ]
[114][ 604][0][ 4]  [    ][    ][    ][UP][     ][    ]
[115][ 607][0][ 6]  [    ][    ][    ][UP][RIGHT][    ]
[116][ 609][0][38]  [FIRE][    ][    ][UP][RIGHT][    ]
[117][ 612][0][ 6]  [    ][    ][    ][UP][RIGHT][    ]
[118][ 615][0][22]  [    ][JUMP][    ][UP][RIGHT][    ]
[119][ 617][0][18]  [    ][JUMP][    ][  ][RIGHT][    ]
[120][ 640][0][ 2]  [    ][    ][    ][  ][RIGHT][    ]
[121][ 660][0][18]  [    ][JUMP][    ][  ][RIGHT][    ]
[122][ 670][0][ 2]  [    ][    ][    ][  ][RIGHT][    ]
[123][ 706][0][ 0]  [    ][    ][    ][  ][     ][    ]
[124][ 709][0][16]  [    ][JUMP][    ][  ][     ][    ]
[125][ 725][0][18]  [    ][JUMP][    ][  ][RIGHT][    ]
[126][ 731][0][ 0]  [    ][    ][    ][  ][     ][    ]
[127][ 738][0][ 2]  [    ][    ][    ][  ][RIGHT][    ]
[128][ 746]-------------LEVEL DONE 1 ---------------- 
[129][ 826]-------------LEVEL DONE 2 ---------------- 
[130][1546]-------------NEXT LEVEL!------------------ 
[131][ 840]-------------PLAYER 0 ACKNOWLEDGE------ 
[132][ 841]-------------NEXT LEVEL!------------------ 
