number of entries 57
deathmatch_pbullets 0
deathmatch_pbullets_damage 5
suicide_pbullets 0
[ gm][  pc][p][cm]
[  0][   0]-------------START (level:40)------------- 
[  1][   0]-------------PLAYER 0 ACTIVE (color:8)-- 
[  2][  29][0][ 2]  [    ][    ][    ][  ][RIGHT][    ]
[  3][  42][0][18]  [    ][JUMP][    ][  ][RIGHT][    ]
[  4][  56][0][ 0]  [    ][    ][    ][  ][     ][    ]
[  5][  57][0][32]  [FIRE][    ][    ][  ][     ][    ]
[  6][  61][0][ 0]  [    ][    ][    ][  ][     ][    ]
[  7][  62][0][ 2]  [    ][    ][    ][  ][RIGHT][    ]
[  8][  69][0][ 0]  [    ][    ][    ][  ][     ][    ]
[  9][  74][0][ 2]  [    ][    ][    ][  ][RIGHT][    ]
[ 10][  89][0][ 1]  [    ][    ][    ][  ][     ][LEFT]
[ 11][ 101][0][17]  [    ][JUMP][    ][  ][     ][LEFT]
[ 12][ 117][0][49]  [FIRE][JUMP][    ][  ][     ][LEFT]
[ 13][ 118][0][48]  [FIRE][JUMP][    ][  ][     ][    ]
[ 14][ 119][0][32]  [FIRE][    ][    ][  ][     ][    ]
[ 15][ 124][0][34]  [FIRE][    ][    ][  ][RIGHT][    ]
[ 16][ 153][0][32]  [FIRE][    ][    ][  ][     ][    ]
[ 17][ 160][0][33]  [FIRE][    ][    ][  ][     ][LEFT]
[ 18][ 171][0][32]  [FIRE][    ][    ][  ][     ][    ]
[ 19][ 183][0][34]  [FIRE][    ][    ][  ][RIGHT][    ]
[ 20][ 187][0][32]  [FIRE][    ][    ][  ][     ][    ]
[ 21][ 197][0][ 0]  [    ][    ][    ][  ][     ][    ]
[ 22][ 198][0][ 2]  [    ][    ][    ][  ][RIGHT][    ]
[ 23][ 230][0][ 1]  [    ][    ][    ][  ][     ][LEFT]
[ 24][ 243][0][17]  [    ][JUMP][    ][  ][     ][LEFT]
[ 25][ 249][0][16]  [    ][JUMP][    ][  ][     ][    ]
[ 26][ 251][0][48]  [FIRE][JUMP][    ][  ][     ][    ]
[ 27][ 252][0][32]  [FIRE][    ][    ][  ][     ][    ]
[ 28][ 254][0][ 0]  [    ][    ][    ][  ][     ][    ]
[ 29][ 258][0][32]  [FIRE][    ][    ][  ][     ][    ]
[ 30][ 261][0][ 0]  [    ][    ][    ][  ][     ][    ]
[ 31][ 265][0][32]  [FIRE][    ][    ][  ][     ][    ]
[ 32][ 267][0][ 0]  [    ][    ][    ][  ][     ][    ]
[ 33][ 270][0][32]  [FIRE][    ][    ][  ][     ][    ]
[ 34][ 273][0][ 0]  [    ][    ][    ][  ][     ][    ]
[ 35][ 275][0][48]  [FIRE][JUMP][    ][  ][     ][    ]
[ 36][ 281][0][32]  [FIRE][    ][    ][  ][     ][    ]
[ 37][ 284][0][48]  [FIRE][JUMP][    ][  ][     ][    ]
[ 38][ 287][0][16]  [    ][JUMP][    ][  ][     ][    ]
[ 39][ 288][0][ 0]  [    ][    ][    ][  ][     ][    ]
[ 40][ 293][0][ 2]  [    ][    ][    ][  ][RIGHT][    ]
[ 41][ 340][0][18]  [    ][JUMP][    ][  ][RIGHT][    ]
[ 42][ 366][0][ 2]  [    ][    ][    ][  ][RIGHT][    ]
[ 43][ 369][0][ 0]  [    ][    ][    ][  ][     ][    ]
[ 44][ 381][0][16]  [    ][JUMP][    ][  ][     ][    ]
[ 45][ 386][0][18]  [    ][JUMP][    ][  ][RIGHT][    ]
[ 46][ 391][0][ 2]  [    ][    ][    ][  ][RIGHT][    ]
[ 47][ 394][0][ 0]  [    ][    ][    ][  ][     ][    ]
[ 48][ 425][0][ 2]  [    ][    ][    ][  ][RIGHT][    ]
[ 49][ 429][0][ 0]  [    ][    ][    ][  ][     ][    ]
[ 50][ 440][0][ 2]  [    ][    ][    ][  ][RIGHT][    ]
[ 51][ 448][0][16]  [    ][JUMP][    ][  ][     ][    ]
[ 52][ 456]-------------LEVEL DONE 1 ---------------- 
[ 53][ 536]-------------LEVEL DONE 2 ---------------- 
[ 54][1256]-------------NEXT LEVEL!------------------ 
[ 55][ 558]-------------PLAYER 0 ACKNOWLEDGE------ 
[ 56][ 559]-------------NEXT LEVEL!------------------ 
