number of entries 65
deathmatch_pbullets 0
deathmatch_pbullets_damage 5
suicide_pbullets 0
[ gm][  pc][p][cm]
[  0][   0]-------------START (level:40)------------- 
[  1][   0]-------------PLAYER 0 ACTIVE (color:8)-- 
[  2][  23][0][ 2]  [    ][    ][    ][  ][RIGHT][    ]
[  3][  37][0][18]  [    ][JUMP][    ][  ][RIGHT][    ]
[  4][  51][0][50]  [FIRE][JUMP][    ][  ][RIGHT][    ]
[  5][  53][0][34]  [FIRE][    ][    ][  ][RIGHT][    ]
[  6][  56][0][ 2]  [    ][    ][    ][  ][RIGHT][    ]
[  7][  60][0][34]  [FIRE][    ][    ][  ][RIGHT][    ]
[  8][  62][0][32]  [FIRE][    ][    ][  ][     ][    ]
[  9][  63][0][33]  [FIRE][    ][    ][  ][     ][LEFT]
[ 10][  64][0][ 1]  [    ][    ][    ][  ][     ][LEFT]
[ 11][  68][0][33]  [FIRE][    ][    ][  ][     ][LEFT]
[ 12][  78][0][32]  [FIRE][    ][    ][  ][     ][    ]
[ 13][  89][0][34]  [FIRE][    ][    ][  ][RIGHT][    ]
[ 14][  92][0][32]  [FIRE][    ][    ][  ][     ][    ]
[ 15][  99][0][34]  [FIRE][    ][    ][  ][RIGHT][    ]
[ 16][ 103][0][32]  [FIRE][    ][    ][  ][     ][    ]
[ 17][ 109][0][34]  [FIRE][    ][    ][  ][RIGHT][    ]
[ 18][ 112][0][32]  [FIRE][    ][    ][  ][     ][    ]
[ 19][ 118][0][34]  [FIRE][    ][    ][  ][RIGHT][    ]
[ 20][ 121][0][32]  [FIRE][    ][    ][  ][     ][    ]
[ 21][ 127][0][34]  [FIRE][    ][    ][  ][RIGHT][    ]
[ 22][ 130][0][32]  [FIRE][    ][    ][  ][     ][    ]
[ 23][ 136][0][34]  [FIRE][    ][    ][  ][RIGHT][    ]
[ 24][ 139][0][32]  [FIRE][    ][    ][  ][     ][    ]
[ 25][ 144][0][34]  [FIRE][    ][    ][  ][RIGHT][    ]
[ 26][ 147][0][32]  [FIRE][    ][    ][  ][     ][    ]
[ 27][ 170][0][ 0]  [    ][    ][    ][  ][     ][    ]
[ 28][ 172][0][ 2]  [    ][    ][    ][  ][RIGHT][    ]
[ 29][ 186][0][18]  [    ][JUMP][    ][  ][RIGHT][    ]
[ 30][ 197][0][ 2]  [    ][    ][    ][  ][RIGHT][    ]
[ 31][ 218][0][ 3]  [    ][    ][    ][  ][RIGHT][LEFT]
[ 32][ 219][0][ 1]  [    ][    ][    ][  ][     ][LEFT]
[ 33][ 220][0][33]  [FIRE][    ][    ][  ][     ][LEFT]
[ 34][ 223][0][ 1]  [    ][    ][    ][  ][     ][LEFT]
[ 35][ 224][0][ 0]  [    ][    ][    ][  ][     ][    ]
[ 36][ 227][0][32]  [FIRE][    ][    ][  ][     ][    ]
[ 37][ 228][0][ 0]  [    ][    ][    ][  ][     ][    ]
[ 38][ 233][0][32]  [FIRE][    ][    ][  ][     ][    ]
[ 39][ 235][0][ 0]  [    ][    ][    ][  ][     ][    ]
[ 40][ 238][0][16]  [    ][JUMP][    ][  ][     ][    ]
[ 41][ 239][0][48]  [FIRE][JUMP][    ][  ][     ][    ]
[ 42][ 241][0][16]  [    ][JUMP][    ][  ][     ][    ]
[ 43][ 242][0][ 0]  [    ][    ][    ][  ][     ][    ]
[ 44][ 244][0][32]  [FIRE][    ][    ][  ][     ][    ]
[ 45][ 247][0][48]  [FIRE][JUMP][    ][  ][     ][    ]
[ 46][ 248][0][ 0]  [    ][    ][    ][  ][     ][    ]
[ 47][ 251][0][ 2]  [    ][    ][    ][  ][RIGHT][    ]
[ 48][ 269][0][18]  [    ][JUMP][    ][  ][RIGHT][    ]
[ 49][ 299][0][ 2]  [    ][    ][    ][  ][RIGHT][    ]
[ 50][ 300][0][ 0]  [    ][    ][    ][  ][     ][    ]
[ 51][ 307][0][ 1]  [    ][    ][    ][  ][     ][LEFT]
[ 52][ 310][0][ 0]  [    ][    ][    ][  ][     ][    ]
[ 53][ 311][0][16]  [    ][JUMP][    ][  ][     ][    ]
[ 54][ 317][0][18]  [    ][JUMP][    ][  ][RIGHT][    ]
[ 55][ 326][0][ 2]  [    ][    ][    ][  ][RIGHT][    ]
[ 56][ 327][0][ 0]  [    ][    ][    ][  ][     ][    ]
[ 57][ 361][0][ 2]  [    ][    ][    ][  ][RIGHT][    ]
[ 58][ 367][0][18]  [    ][JUMP][    ][  ][RIGHT][    ]
[ 59][ 368][0][16]  [    ][JUMP][    ][  ][     ][    ]
[ 60][ 375]-------------LEVEL DONE 1 ---------------- 
[ 61][ 455]-------------LEVEL DONE 2 ---------------- 
[ 62][1175]-------------NEXT LEVEL!------------------ 
[ 63][ 459]-------------PLAYER 0 ACKNOWLEDGE------ 
[ 64][ 460]-------------NEXT LEVEL!------------------ 
