number of entries 137
deathmatch_pbullets 0
deathmatch_pbullets_damage 5
suicide_pbullets 0
[ gm][  pc][p][cm]
[  0][   0]-------------START (level:14)------------- 
[  1][   0]-------------PLAYER 0 ACTIVE (color:8)-- 
[  2][  34][0][ 2]  [    ][    ][    ][  ][RIGHT][    ]
[  3][  61][0][ 0]  [    ][    ][    ][  ][     ][    ]
[  4][  69][0][ 4]  [    ][    ][    ][UP][     ][    ]
[  5][  78][0][36]  [FIRE][    ][    ][UP][     ][    ]
[  6][  81][0][ 4]  [    ][    ][    ][UP][     ][    ]
[  7][  85][0][ 0]  [    ][    ][    ][  ][     ][    ]
[  8][  92][0][ 2]  [    ][    ][    ][  ][RIGHT][    ]
[  9][ 102][0][ 0]  [    ][    ][    ][  ][     ][    ]
[ 10][ 109][0][ 4]  [    ][    ][    ][UP][     ][    ]
[ 11][ 115][0][36]  [FIRE][    ][    ][UP][     ][    ]
[ 12][ 119][0][ 4]  [    ][    ][    ][UP][     ][    ]
[ 13][ 128][0][ 0]  [    ][    ][    ][  ][     ][    ]
[ 14][ 136][0][ 1]  [    ][    ][    ][  ][     ][LEFT]
[ 15][ 146][0][ 0]  [    ][    ][    ][  ][     ][    ]
[ 16][ 149][0][ 4]  [    ][    ][    ][UP][     ][    ]
[ 17][ 154][0][36]  [FIRE][    ][    ][UP][     ][    ]
[ 18][ 158][0][ 4]  [    ][    ][    ][UP][     ][    ]
[ 19][ 163][0][ 0]  [    ][    ][    ][  ][     ][    ]
[ 20][ 172][0][ 2]  [    ][    ][    ][  ][RIGHT][    ]
[ 21][ 238][0][ 0]  [    ][    ][    ][  ][     ][    ]
[ 22][ 249][0][ 4]  [    ][    ][    ][UP][     ][    ]
[ 23][ 254][0][36]  [FIRE][    ][    ][UP][     ][    ]
[ 24][ 258][0][ 4]  [    ][    ][    ][UP][     ][    ]
[ 25][ 262][0][ 0]  [    ][    ][    ][  ][     ][    ]
[ 26][ 268][0][ 2]  [    ][    ][    ][  ][RIGHT][    ]
[ 27][ 277][0][ 0]  [    ][    ][    ][  ][     ][    ]
[ 28][ 287][0][ 2]  [    ][    ][    ][  ][RIGHT][    ]
[ 29][ 292][0][ 0]  [    ][    ][    ][  ][     ][    ]
[ 30][ 297][0][ 4]  [    ][    ][    ][UP][     ][    ]
[ 31][ 300][0][36]  [FIRE][    ][    ][UP][     ][    ]
[ 32][ 304][0][ 4]  [    ][    ][    ][UP][     ][    ]
[ 33][ 311][0][ 0]  [    ][    ][    ][  ][     ][    ]
[ 34][ 322][0][ 1]  [    ][    ][    ][  ][     ][LEFT]
[ 35][ 331][0][ 0]  [    ][    ][    ][  ][     ][    ]
[ 36][ 335][0][ 1]  [    ][    ][    ][  ][     ][LEFT]
[ 37][ 338][0][ 4]  [    ][    ][    ][UP][     ][    ]
[ 38][ 346][0][36]  [FIRE][    ][    ][UP][     ][    ]
[ 39][ 349][0][ 4]  [    ][    ][    ][UP][     ][    ]
[ 40][ 360][0][ 0]  [    ][    ][    ][  ][     ][    ]
[ 41][ 370][0][ 2]  [    ][    ][    ][  ][RIGHT][    ]
[ 42][ 383][0][ 0]  [    ][    ][    ][  ][     ][    ]
[ 43][ 386][0][ 4]  [    ][    ][    ][UP][     ][    ]
[ 44][ 388][0][36]  [FIRE][    ][    ][UP][     ][    ]
[ 45][ 394][0][ 4]  [    ][    ][    ][UP][     ][    ]
[ 46][ 403][0][ 5]  [    ][    ][    ][UP][     ][LEFT]
[ 47][ 405][0][ 1]  [    ][    ][    ][  ][     ][LEFT]
[ 48][ 414][0][ 0]  [    ][    ][    ][  ][     ][    ]
[ 49][ 418][0][ 4]  [    ][    ][    ][UP][     ][    ]
[ 50][ 431][0][ 5]  [    ][    ][    ][UP][     ][LEFT]
[ 51][ 436][0][ 4]  [    ][    ][    ][UP][     ][    ]
[ 52][ 437][0][36]  [FIRE][    ][    ][UP][     ][    ]
[ 53][ 441][0][ 4]  [    ][    ][    ][UP][     ][    ]
[ 54][ 451][0][ 0]  [    ][    ][    ][  ][     ][    ]
[ 55][ 454][0][ 2]  [    ][    ][    ][  ][RIGHT][    ]
[ 56][ 467][0][ 0]  [    ][    ][    ][  ][     ][    ]
[ 57][ 470][0][ 4]  [    ][    ][    ][UP][     ][    ]
[ 58][ 476][0][36]  [FIRE][    ][    ][UP][     ][    ]
[ 59][ 479][0][ 4]  [    ][    ][    ][UP][     ][    ]
[ 60][ 488][0][ 0]  [    ][    ][    ][  ][     ][    ]
[ 61][ 505][0][ 1]  [    ][    ][    ][  ][     ][LEFT]
[ 62][ 516][0][ 5]  [    ][    ][    ][UP][     ][LEFT]
[ 63][ 517][0][ 4]  [    ][    ][    ][UP][     ][    ]
[ 64][ 525][0][36]  [FIRE][    ][    ][UP][     ][    ]
[ 65][ 529][0][ 4]  [    ][    ][    ][UP][     ][    ]
[ 66][ 544][0][ 0]  [    ][    ][    ][  ][     ][    ]
[ 67][ 549][0][ 2]  [    ][    ][    ][  ][RIGHT][    ]
[ 68][ 561][0][ 0]  [    ][    ][    ][  ][     ][    ]
[ 69][ 564][0][ 4]  [    ][    ][    ][UP][     ][    ]
[ 70][ 569][0][36]  [FIRE][    ][    ][UP][     ][    ]
[ 71][ 572][0][ 4]  [    ][    ][    ][UP][     ][    ]
[ 72][ 587][0][ 5]  [    ][    ][    ][UP][     ][LEFT]
[ 73][ 589][0][ 1]  [    ][    ][    ][  ][     ][LEFT]
[ 74][ 597][0][ 0]  [    ][    ][    ][  ][     ][    ]
[ 75][ 606][0][ 1]  [    ][    ][    ][  ][     ][LEFT]
[ 76][ 629][0][ 0]  [    ][    ][    ][  ][     ][    ]
[ 77][ 639][0][ 1]  [    ][    ][    ][  ][     ][LEFT]
[ 78][ 641][0][ 0]  [    ][    ][    ][  ][     ][    ]
[ 79][ 650][0][ 1]  [    ][    ][    ][  ][     ][LEFT]
[ 80][ 655][0][ 0]  [    ][    ][    ][  ][     ][    ]
[ 81][ 662][0][ 1]  [    ][    ][    ][  ][     ][LEFT]
[ 82][ 665][0][ 0]  [    ][    ][    ][  ][     ][    ]
[ 83][ 680][0][ 4]  [    ][    ][    ][UP][     ][    ]
[ 84][ 685][0][36]  [FIRE][    ][    ][UP][     ][    ]
[ 85][ 689][0][ 4]  [    ][    ][    ][UP][     ][    ]
[ 86][ 693][0][ 0]  [    ][    ][    ][  ][     ][    ]
[ 87][ 708][0][ 2]  [    ][    ][    ][  ][RIGHT][    ]
[ 88][ 714][0][ 0]  [    ][    ][    ][  ][     ][    ]
[ 89][ 720][0][ 2]  [    ][    ][    ][  ][RIGHT][    ]
[ 90][ 721][0][ 0]  [    ][    ][    ][  ][     ][    ]
[ 91][ 726][0][ 4]  [    ][    ][    ][UP][     ][    ]
[ 92][ 729][0][36]  [FIRE][    ][    ][UP][     ][    ]
[ 93][ 732][0][ 4]  [    ][    ][    ][UP][     ][    ]
[ 94][ 740][0][ 0]  [    ][    ][    ][  ][     ][    ]
[ 95][ 762][0][ 4]  [    ][    ][    ][UP][     ][    ]
[ 96][ 770][0][36]  [FIRE][    ][    ][UP][     ][    ]
[ 97][ 773][0][37]  [FIRE][    ][    ][UP][     ][LEFT]
[ 98][ 774][0][ 5]  [    ][    ][    ][UP][     ][LEFT]
[ 99][ 777][0][ 4]  [    ][    ][    ][UP][     ][    ]
[100][ 793][0][ 0]  [    ][    ][    ][  ][     ][    ]
[101][ 802][0][ 4]  [    ][    ][    ][UP][     ][    ]
[102][ 806][0][36]  [FIRE][    ][    ][UP][     ][    ]
[103][ 810][0][ 4]  [    ][    ][    ][UP][     ][    ]
[104][ 832][0][ 0]  [    ][    ][    ][  ][     ][    ]
[105][ 840][0][ 1]  [    ][    ][    ][  ][     ][LEFT]
[106][ 844][0][ 0]  [    ][    ][    ][  ][     ][    ]
[107][ 852][0][ 4]  [    ][    ][    ][UP][     ][    ]
[108][ 857][0][36]  [FIRE][    ][    ][UP][     ][    ]
[109][ 860][0][ 4]  [    ][    ][    ][UP][     ][    ]
[110][ 868][0][ 0]  [    ][    ][    ][  ][     ][    ]
[111][ 880][0][ 1]  [    ][    ][    ][  ][     ][LEFT]
[112][ 888][0][ 0]  [    ][    ][    ][  ][     ][    ]
[113][ 898][0][ 4]  [    ][    ][    ][UP][     ][    ]
[114][ 905][0][36]  [FIRE][    ][    ][UP][     ][    ]
[115][ 909][0][ 4]  [    ][    ][    ][UP][     ][    ]
[116][ 914][0][ 0]  [    ][    ][    ][  ][     ][    ]
[117][ 927][0][ 2]  [    ][    ][    ][  ][RIGHT][    ]
[118][ 933][0][ 0]  [    ][    ][    ][  ][     ][    ]
[119][ 939][0][ 4]  [    ][    ][    ][UP][     ][    ]
[120][ 945][0][36]  [FIRE][    ][    ][UP][     ][    ]
[121][ 948][0][ 4]  [    ][    ][    ][UP][     ][    ]
[122][ 957][0][17]  [    ][JUMP][    ][  ][     ][LEFT]
[123][ 967][0][ 1]  [    ][    ][    ][  ][     ][LEFT]
[124][ 980][0][ 0]  [    ][    ][    ][  ][     ][    ]
[125][1000][0][ 2]  [    ][    ][    ][  ][RIGHT][    ]
[126][1013][0][18]  [    ][JUMP][    ][  ][RIGHT][    ]
[127][1017][0][ 2]  [    ][    ][    ][  ][RIGHT][    ]
[128][1026][0][ 0]  [    ][    ][    ][  ][     ][    ]
[129][1038][0][ 2]  [    ][    ][    ][  ][RIGHT][    ]
[130][1050][0][ 1]  [    ][    ][    ][  ][     ][LEFT]
[131][1063][0][ 0]  [    ][    ][    ][  ][     ][    ]
[132][1069]-------------LEVEL DONE 1 ---------------- 
[133][1149]-------------LEVEL DONE 2 ---------------- 
[134][1869]-------------NEXT LEVEL!------------------ 
[135][1162]-------------PLAYER 0 ACKNOWLEDGE------ 
[136][1163]-------------NEXT LEVEL!------------------ 
