number of entries 56
deathmatch_pbullets 1
deathmatch_pbullets_damage 5
suicide_pbullets 1
[ gm][  pc][p][cm]
[  0][   0]-------------START (level:42)------------- 
[  1][   0]-------------PLAYER 0 ACTIVE (color:8)-- 
[  2][  75][0][ 2]  [    ][    ][    ][  ][RIGHT][    ]
[  3][  91][0][34]  [FIRE][    ][    ][  ][RIGHT][    ]
[  4][  93][0][32]  [FIRE][    ][    ][  ][     ][    ]
[  5][  94][0][33]  [FIRE][    ][    ][  ][     ][LEFT]
[  6][  96][0][49]  [FIRE][JUMP][    ][  ][     ][LEFT]
[  7][  98][0][17]  [    ][JUMP][    ][  ][     ][LEFT]
[  8][ 101][0][50]  [FIRE][JUMP][    ][  ][RIGHT][    ]
[  9][ 102][0][34]  [FIRE][    ][    ][  ][RIGHT][    ]
[ 10][ 103][0][32]  [FIRE][    ][    ][  ][     ][    ]
[ 11][ 104][0][ 0]  [    ][    ][    ][  ][     ][    ]
[ 12][ 107][0][32]  [FIRE][    ][    ][  ][     ][    ]
[ 13][ 109][0][ 0]  [    ][    ][    ][  ][     ][    ]
[ 14][ 110][0][ 2]  [    ][    ][    ][  ][RIGHT][    ]
[ 15][ 114][0][34]  [FIRE][    ][    ][  ][RIGHT][    ]
[ 16][ 117][0][ 2]  [    ][    ][    ][  ][RIGHT][    ]
[ 17][ 120][0][ 0]  [    ][    ][    ][  ][     ][    ]
[ 18][ 121][0][32]  [FIRE][    ][    ][  ][     ][    ]
[ 19][ 122][0][34]  [FIRE][    ][    ][  ][RIGHT][    ]
[ 20][ 124][0][ 6]  [    ][    ][    ][UP][RIGHT][    ]
[ 21][ 131][0][ 2]  [    ][    ][    ][  ][RIGHT][    ]
[ 22][ 134][0][ 0]  [    ][    ][    ][  ][     ][    ]
[ 23][ 138][0][16]  [    ][JUMP][    ][  ][     ][    ]
[ 24][ 141][0][17]  [    ][JUMP][    ][  ][     ][LEFT]
[ 25][ 151][0][16]  [    ][JUMP][    ][  ][     ][    ]
[ 26][ 152][0][ 0]  [    ][    ][    ][  ][     ][    ]
[ 27][ 155][0][ 2]  [    ][    ][    ][  ][RIGHT][    ]
[ 28][ 181][0][18]  [    ][JUMP][    ][  ][RIGHT][    ]
[ 29][ 188][0][ 0]  [    ][    ][    ][  ][     ][    ]
[ 30][ 192][0][ 1]  [    ][    ][    ][  ][     ][LEFT]
[ 31][ 197][0][ 0]  [    ][    ][    ][  ][     ][    ]
[ 32][ 224][0][ 2]  [    ][    ][    ][  ][RIGHT][    ]
[ 33][ 231][0][16]  [    ][JUMP][    ][  ][     ][    ]
[ 34][ 239][0][18]  [    ][JUMP][    ][  ][RIGHT][    ]
[ 35][ 241][0][ 2]  [    ][    ][    ][  ][RIGHT][    ]
[ 36][ 244][0][ 0]  [    ][    ][    ][  ][     ][    ]
[ 37][ 278][0][ 2]  [    ][    ][    ][  ][RIGHT][    ]
[ 38][ 289][0][ 0]  [    ][    ][    ][  ][     ][    ]
[ 39][ 295][0][ 2]  [    ][    ][    ][  ][RIGHT][    ]
[ 40][ 301][0][ 0]  [    ][    ][    ][  ][     ][    ]
[ 41][ 305][0][ 1]  [    ][    ][    ][  ][     ][LEFT]
[ 42][ 310][0][17]  [    ][JUMP][    ][  ][     ][LEFT]
[ 43][ 316][0][18]  [    ][JUMP][    ][  ][RIGHT][    ]
[ 44][ 318][0][22]  [    ][JUMP][    ][UP][RIGHT][    ]
[ 45][ 324][0][ 6]  [    ][    ][    ][UP][RIGHT][    ]
[ 46][ 326][0][ 2]  [    ][    ][    ][  ][RIGHT][    ]
[ 47][ 330][0][ 0]  [    ][    ][    ][  ][     ][    ]
[ 48][ 334][0][ 1]  [    ][    ][    ][  ][     ][LEFT]
[ 49][ 337][0][17]  [    ][JUMP][    ][  ][     ][LEFT]
[ 50][ 339][0][16]  [    ][JUMP][    ][  ][     ][    ]
[ 51][ 345]-------------LEVEL DONE 1 ---------------- 
[ 52][ 425]-------------LEVEL DONE 2 ---------------- 
[ 53][1145]-------------NEXT LEVEL!------------------ 
[ 54][ 478]-------------PLAYER 0 ACKNOWLEDGE------ 
[ 55][ 479]-------------NEXT LEVEL!------------------ 
