number of entries 300
deathmatch_pbullets 1
deathmatch_pbullets_damage 5
suicide_pbullets 1
[ gm][  pc][p][cm]
[  0][   0]-------------START (level:94)------------- 
[  1][   0]-------------PLAYER 0 ACTIVE (color:8)-- 
[  2][  80][0][16]  [    ][JUMP][    ][  ][     ][    ]
[  3][  85][0][17]  [    ][JUMP][    ][  ][     ][LEFT]
[  4][  96][0][ 1]  [    ][    ][    ][  ][     ][LEFT]
[  5][ 108][0][ 0]  [    ][    ][    ][  ][     ][    ]
[  6][ 111][0][ 2]  [    ][    ][    ][  ][RIGHT][    ]
[  7][ 122][0][18]  [    ][JUMP][    ][  ][RIGHT][    ]
[  8][ 147][0][ 1]  [    ][    ][    ][  ][     ][LEFT]
[  9][ 153][0][ 2]  [    ][    ][    ][  ][RIGHT][    ]
[ 10][ 183][0][ 0]  [    ][    ][    ][  ][     ][    ]
[ 11][ 186][0][ 1]  [    ][    ][    ][  ][     ][LEFT]
[ 12][ 190][0][ 0]  [    ][    ][    ][  ][     ][    ]
[ 13][ 206][0][ 1]  [    ][    ][    ][  ][     ][LEFT]
[ 14][ 216][0][ 0]  [    ][    ][    ][  ][     ][    ]
[ 15][ 217][0][ 2]  [    ][    ][    ][  ][RIGHT][    ]
[ 16][ 222][0][ 1]  [    ][    ][    ][  ][     ][LEFT]
[ 17][ 227][0][ 3]  [    ][    ][    ][  ][RIGHT][LEFT]
[ 18][ 228][0][ 6]  [    ][    ][    ][UP][RIGHT][    ]
[ 19][ 234][0][ 1]  [    ][    ][    ][  ][     ][LEFT]
[ 20][ 236][0][17]  [    ][JUMP][    ][  ][     ][LEFT]
[ 21][ 237][0][16]  [    ][JUMP][    ][  ][     ][    ]
[ 22][ 239][0][18]  [    ][JUMP][    ][  ][RIGHT][    ]
[ 23][ 240][0][22]  [    ][JUMP][    ][UP][RIGHT][    ]
[ 24][ 242][0][54]  [FIRE][JUMP][    ][UP][RIGHT][    ]
[ 25][ 245][0][52]  [FIRE][JUMP][    ][UP][     ][    ]
[ 26][ 246][0][33]  [FIRE][    ][    ][  ][     ][LEFT]
[ 27][ 250][0][ 1]  [    ][    ][    ][  ][     ][LEFT]
[ 28][ 251][0][ 6]  [    ][    ][    ][UP][RIGHT][    ]
[ 29][ 252][0][22]  [    ][JUMP][    ][UP][RIGHT][    ]
[ 30][ 256][0][37]  [FIRE][    ][    ][UP][     ][LEFT]
[ 31][ 257][0][33]  [FIRE][    ][    ][  ][     ][LEFT]
[ 32][ 259][0][ 0]  [    ][    ][    ][  ][     ][    ]
[ 33][ 261][0][ 6]  [    ][    ][    ][UP][RIGHT][    ]
[ 34][ 270][0][ 4]  [    ][    ][    ][UP][     ][    ]
[ 35][ 272][0][17]  [    ][JUMP][    ][  ][     ][LEFT]
[ 36][ 276][0][53]  [FIRE][JUMP][    ][UP][     ][LEFT]
[ 37][ 277][0][52]  [FIRE][JUMP][    ][UP][     ][    ]
[ 38][ 278][0][36]  [FIRE][    ][    ][UP][     ][    ]
[ 39][ 282][0][33]  [FIRE][    ][    ][  ][     ][LEFT]
[ 40][ 283][0][17]  [    ][JUMP][    ][  ][     ][LEFT]
[ 41][ 287][0][22]  [    ][JUMP][    ][UP][RIGHT][    ]
[ 42][ 289][0][ 6]  [    ][    ][    ][UP][RIGHT][    ]
[ 43][ 291][0][ 4]  [    ][    ][    ][UP][     ][    ]
[ 44][ 292][0][ 5]  [    ][    ][    ][UP][     ][LEFT]
[ 45][ 293][0][ 1]  [    ][    ][    ][  ][     ][LEFT]
[ 46][ 297][0][ 6]  [    ][    ][    ][UP][RIGHT][    ]
[ 47][ 302][0][ 1]  [    ][    ][    ][  ][     ][LEFT]
[ 48][ 307][0][ 6]  [    ][    ][    ][UP][RIGHT][    ]
[ 49][ 311][0][ 4]  [    ][    ][    ][UP][     ][    ]
[ 50][ 312][0][ 1]  [    ][    ][    ][  ][     ][LEFT]
[ 51][ 316][0][ 6]  [    ][    ][    ][UP][RIGHT][    ]
[ 52][ 322][0][ 4]  [    ][    ][    ][UP][     ][    ]
[ 53][ 323][0][ 0]  [    ][    ][    ][  ][     ][    ]
[ 54][ 326][0][48]  [FIRE][JUMP][    ][  ][     ][    ]
[ 55][ 336][0][ 0]  [    ][    ][    ][  ][     ][    ]
[ 56][ 338][0][ 6]  [    ][    ][    ][UP][RIGHT][    ]
[ 57][ 342][0][ 5]  [    ][    ][    ][UP][     ][LEFT]
[ 58][ 343][0][ 1]  [    ][    ][    ][  ][     ][LEFT]
[ 59][ 348][0][ 6]  [    ][    ][    ][UP][RIGHT][    ]
[ 60][ 353][0][ 4]  [    ][    ][    ][UP][     ][    ]
[ 61][ 354][0][ 0]  [    ][    ][    ][  ][     ][    ]
[ 62][ 359][0][48]  [FIRE][JUMP][    ][  ][     ][    ]
[ 63][ 368][0][16]  [    ][JUMP][    ][  ][     ][    ]
[ 64][ 369][0][ 0]  [    ][    ][    ][  ][     ][    ]
[ 65][ 375][0][ 1]  [    ][    ][    ][  ][     ][LEFT]
[ 66][ 382][0][ 0]  [    ][    ][    ][  ][     ][    ]
[ 67][ 383][0][ 2]  [    ][    ][    ][  ][RIGHT][    ]
[ 68][ 393][0][18]  [    ][JUMP][    ][  ][RIGHT][    ]
[ 69][ 401][0][ 2]  [    ][    ][    ][  ][RIGHT][    ]
[ 70][ 442][0][ 0]  [    ][    ][    ][  ][     ][    ]
[ 71][ 471][0][ 1]  [    ][    ][    ][  ][     ][LEFT]
[ 72][ 474][0][ 2]  [    ][    ][    ][  ][RIGHT][    ]
[ 73][ 476][0][ 6]  [    ][    ][    ][UP][RIGHT][    ]
[ 74][ 479][0][ 1]  [    ][    ][    ][  ][     ][LEFT]
[ 75][ 483][0][ 0]  [    ][    ][    ][  ][     ][    ]
[ 76][ 484][0][ 6]  [    ][    ][    ][UP][RIGHT][    ]
[ 77][ 489][0][ 1]  [    ][    ][    ][  ][     ][LEFT]
[ 78][ 492][0][ 0]  [    ][    ][    ][  ][     ][    ]
[ 79][ 494][0][ 6]  [    ][    ][    ][UP][RIGHT][    ]
[ 80][ 497][0][ 4]  [    ][    ][    ][UP][     ][    ]
[ 81][ 498][0][ 1]  [    ][    ][    ][  ][     ][LEFT]
[ 82][ 502][0][ 0]  [    ][    ][    ][  ][     ][    ]
[ 83][ 503][0][ 6]  [    ][    ][    ][UP][RIGHT][    ]
[ 84][ 506][0][ 5]  [    ][    ][    ][UP][     ][LEFT]
[ 85][ 508][0][ 1]  [    ][    ][    ][  ][     ][LEFT]
[ 86][ 512][0][ 6]  [    ][    ][    ][UP][RIGHT][    ]
[ 87][ 515][0][ 4]  [    ][    ][    ][UP][     ][    ]
[ 88][ 516][0][ 5]  [    ][    ][    ][UP][     ][LEFT]
[ 89][ 517][0][ 1]  [    ][    ][    ][  ][     ][LEFT]
[ 90][ 522][0][ 6]  [    ][    ][    ][UP][RIGHT][    ]
[ 91][ 526][0][ 4]  [    ][    ][    ][UP][     ][    ]
[ 92][ 527][0][ 1]  [    ][    ][    ][  ][     ][LEFT]
[ 93][ 530][0][ 0]  [    ][    ][    ][  ][     ][    ]
[ 94][ 531][0][ 2]  [    ][    ][    ][  ][RIGHT][    ]
[ 95][ 532][0][ 6]  [    ][    ][    ][UP][RIGHT][    ]
[ 96][ 534][0][ 2]  [    ][    ][    ][  ][RIGHT][    ]
[ 97][ 535][0][ 0]  [    ][    ][    ][  ][     ][    ]
[ 98][ 540][0][16]  [    ][JUMP][    ][  ][     ][    ]
[ 99][ 546][0][ 0]  [    ][    ][    ][  ][     ][    ]
[100][ 564][0][16]  [    ][JUMP][    ][  ][     ][    ]
[101][ 569][0][ 0]  [    ][    ][    ][  ][     ][    ]
[102][ 589][0][16]  [    ][JUMP][    ][  ][     ][    ]
[103][ 592][0][ 0]  [    ][    ][    ][  ][     ][    ]
[104][ 613][0][16]  [    ][JUMP][    ][  ][     ][    ]
[105][ 617][0][ 0]  [    ][    ][    ][  ][     ][    ]
[106][ 635][0][16]  [    ][JUMP][    ][  ][     ][    ]
[107][ 640][0][ 0]  [    ][    ][    ][  ][     ][    ]
[108][ 650][0][ 1]  [    ][    ][    ][  ][     ][LEFT]
[109][ 673][0][17]  [    ][JUMP][    ][  ][     ][LEFT]
[110][ 680][0][ 1]  [    ][    ][    ][  ][     ][LEFT]
[111][ 704][0][ 0]  [    ][    ][    ][  ][     ][    ]
[112][ 816][0][ 1]  [    ][    ][    ][  ][     ][LEFT]
[113][ 823][0][ 0]  [    ][    ][    ][  ][     ][    ]
[114][ 838][0][ 2]  [    ][    ][    ][  ][RIGHT][    ]
[115][ 842][0][ 0]  [    ][    ][    ][  ][     ][    ]
[116][ 858][0][16]  [    ][JUMP][    ][  ][     ][    ]
[117][ 864][0][ 0]  [    ][    ][    ][  ][     ][    ]
[118][ 888][0][16]  [    ][JUMP][    ][  ][     ][    ]
[119][ 894][0][ 0]  [    ][    ][    ][  ][     ][    ]
[120][ 915][0][16]  [    ][JUMP][    ][  ][     ][    ]
[121][ 921][0][ 0]  [    ][    ][    ][  ][     ][    ]
[122][ 945][0][16]  [    ][JUMP][    ][  ][     ][    ]
[123][ 951][0][ 0]  [    ][    ][    ][  ][     ][    ]
[124][ 973][0][16]  [    ][JUMP][    ][  ][     ][    ]
[125][ 979][0][ 0]  [    ][    ][    ][  ][     ][    ]
[126][1004][0][16]  [    ][JUMP][    ][  ][     ][    ]
[127][1010][0][ 0]  [    ][    ][    ][  ][     ][    ]
[128][1258][0][ 1]  [    ][    ][    ][  ][     ][LEFT]
[129][1273][0][ 0]  [    ][    ][    ][  ][     ][    ]
[130][1286][0][ 2]  [    ][    ][    ][  ][RIGHT][    ]
[131][1291][0][ 0]  [    ][    ][    ][  ][     ][    ]
[132][1292][0][ 1]  [    ][    ][    ][  ][     ][LEFT]
[133][1296][0][ 2]  [    ][    ][    ][  ][RIGHT][    ]
[134][1301][0][ 1]  [    ][    ][    ][  ][     ][LEFT]
[135][1306][0][ 2]  [    ][    ][    ][  ][RIGHT][    ]
[136][1310][0][ 1]  [    ][    ][    ][  ][     ][LEFT]
[137][1316][0][ 2]  [    ][    ][    ][  ][RIGHT][    ]
[138][1321][0][ 1]  [    ][    ][    ][  ][     ][LEFT]
[139][1325][0][ 0]  [    ][    ][    ][  ][     ][    ]
[140][1326][0][ 2]  [    ][    ][    ][  ][RIGHT][    ]
[141][1331][0][ 1]  [    ][    ][    ][  ][     ][LEFT]
[142][1334][0][ 0]  [    ][    ][    ][  ][     ][    ]
[143][1335][0][ 2]  [    ][    ][    ][  ][RIGHT][    ]
[144][1340][0][ 1]  [    ][    ][    ][  ][     ][LEFT]
[145][1344][0][ 0]  [    ][    ][    ][  ][     ][    ]
[146][1345][0][ 2]  [    ][    ][    ][  ][RIGHT][    ]
[147][1350][0][ 1]  [    ][    ][    ][  ][     ][LEFT]
[148][1355][0][ 2]  [    ][    ][    ][  ][RIGHT][    ]
[149][1360][0][ 1]  [    ][    ][    ][  ][     ][LEFT]
[150][1365][0][ 2]  [    ][    ][    ][  ][RIGHT][    ]
[151][1370][0][ 1]  [    ][    ][    ][  ][     ][LEFT]
[152][1374][0][ 0]  [    ][    ][    ][  ][     ][    ]
[153][1375][0][ 2]  [    ][    ][    ][  ][RIGHT][    ]
[154][1379][0][ 1]  [    ][    ][    ][  ][     ][LEFT]
[155][1383][0][ 2]  [    ][    ][    ][  ][RIGHT][    ]
[156][1399][0][18]  [    ][JUMP][    ][  ][RIGHT][    ]
[157][1411][0][ 2]  [    ][    ][    ][  ][RIGHT][    ]
[158][1454][0][ 0]  [    ][    ][    ][  ][     ][    ]
[159][1471][0][ 1]  [    ][    ][    ][  ][     ][LEFT]
[160][1476][0][ 0]  [    ][    ][    ][  ][     ][    ]
[161][1484][0][ 1]  [    ][    ][    ][  ][     ][LEFT]
[162][1488][0][ 0]  [    ][    ][    ][  ][     ][    ]
[163][1489][0][ 2]  [    ][    ][    ][  ][RIGHT][    ]
[164][1495][0][ 1]  [    ][    ][    ][  ][     ][LEFT]
[165][1499][0][ 2]  [    ][    ][    ][  ][RIGHT][    ]
[166][1505][0][ 1]  [    ][    ][    ][  ][     ][LEFT]
[167][1509][0][ 2]  [    ][    ][    ][  ][RIGHT][    ]
[168][1536][0][ 0]  [    ][    ][    ][  ][     ][    ]
[169][1561][0][ 1]  [    ][    ][    ][  ][     ][LEFT]
[170][1564][0][ 0]  [    ][    ][    ][  ][     ][    ]
[171][1566][0][ 2]  [    ][    ][    ][  ][RIGHT][    ]
[172][1569][0][ 3]  [    ][    ][    ][  ][RIGHT][LEFT]
[173][1571][0][ 1]  [    ][    ][    ][  ][     ][LEFT]
[174][1575][0][ 0]  [    ][    ][    ][  ][     ][    ]
[175][1576][0][ 2]  [    ][    ][    ][  ][RIGHT][    ]
[176][1580][0][ 1]  [    ][    ][    ][  ][     ][LEFT]
[177][1585][0][ 2]  [    ][    ][    ][  ][RIGHT][    ]
[178][1590][0][ 0]  [    ][    ][    ][  ][     ][    ]
[179][1593][0][ 1]  [    ][    ][    ][  ][     ][LEFT]
[180][1599][0][ 0]  [    ][    ][    ][  ][     ][    ]
[181][1601][0][32]  [FIRE][    ][    ][  ][     ][    ]
[182][1605][0][ 0]  [    ][    ][    ][  ][     ][    ]
[183][1610][0][32]  [FIRE][    ][    ][  ][     ][    ]
[184][1613][0][ 0]  [    ][    ][    ][  ][     ][    ]
[185][1618][0][32]  [FIRE][    ][    ][  ][     ][    ]
[186][1619][0][34]  [FIRE][    ][    ][  ][RIGHT][    ]
[187][1621][0][ 2]  [    ][    ][    ][  ][RIGHT][    ]
[188][1624][0][ 0]  [    ][    ][    ][  ][     ][    ]
[189][1626][0][32]  [FIRE][    ][    ][  ][     ][    ]
[190][1630][0][ 0]  [    ][    ][    ][  ][     ][    ]
[191][1633][0][ 2]  [    ][    ][    ][  ][RIGHT][    ]
[192][1664][0][ 0]  [    ][    ][    ][  ][     ][    ]
[193][1703][0][ 2]  [    ][    ][    ][  ][RIGHT][    ]
[194][1712][0][ 0]  [    ][    ][    ][  ][     ][    ]
[195][1713][0][ 1]  [    ][    ][    ][  ][     ][LEFT]
[196][1722][0][ 2]  [    ][    ][    ][  ][RIGHT][    ]
[197][1726][0][ 1]  [    ][    ][    ][  ][     ][LEFT]
[198][1731][0][ 2]  [    ][    ][    ][  ][RIGHT][    ]
[199][1735][0][ 1]  [    ][    ][    ][  ][     ][LEFT]
[200][1739][0][ 0]  [    ][    ][    ][  ][     ][    ]
[201][1740][0][ 2]  [    ][    ][    ][  ][RIGHT][    ]
[202][1745][0][ 0]  [    ][    ][    ][  ][     ][    ]
[203][1754][0][16]  [    ][JUMP][    ][  ][     ][    ]
[204][1766][0][18]  [    ][JUMP][    ][  ][RIGHT][    ]
[205][1775][0][ 2]  [    ][    ][    ][  ][RIGHT][    ]
[206][1778][0][ 0]  [    ][    ][    ][  ][     ][    ]
[207][1788][0][ 2]  [    ][    ][    ][  ][RIGHT][    ]
[208][1797][0][18]  [    ][JUMP][    ][  ][RIGHT][    ]
[209][1798][0][16]  [    ][JUMP][    ][  ][     ][    ]
[210][1805][0][18]  [    ][JUMP][    ][  ][RIGHT][    ]
[211][1809][0][ 2]  [    ][    ][    ][  ][RIGHT][    ]
[212][1811][0][ 0]  [    ][    ][    ][  ][     ][    ]
[213][1817][0][ 2]  [    ][    ][    ][  ][RIGHT][    ]
[214][1822][0][ 0]  [    ][    ][    ][  ][     ][    ]
[215][1834][0][32]  [FIRE][    ][    ][  ][     ][    ]
[216][1839][0][ 0]  [    ][    ][    ][  ][     ][    ]
[217][1843][0][32]  [FIRE][    ][    ][  ][     ][    ]
[218][1847][0][ 0]  [    ][    ][    ][  ][     ][    ]
[219][1851][0][32]  [FIRE][    ][    ][  ][     ][    ]
[220][1855][0][ 0]  [    ][    ][    ][  ][     ][    ]
[221][1873][0][ 2]  [    ][    ][    ][  ][RIGHT][    ]
[222][1881][0][18]  [    ][JUMP][    ][  ][RIGHT][    ]
[223][1899][0][ 2]  [    ][    ][    ][  ][RIGHT][    ]
[224][1961][0][ 0]  [    ][    ][    ][  ][     ][    ]
[225][1998][0][ 1]  [    ][    ][    ][  ][     ][LEFT]
[226][2005][0][ 2]  [    ][    ][    ][  ][RIGHT][    ]
[227][2010][0][ 1]  [    ][    ][    ][  ][     ][LEFT]
[228][2015][0][ 2]  [    ][    ][    ][  ][RIGHT][    ]
[229][2021][0][ 1]  [    ][    ][    ][  ][     ][LEFT]
[230][2025][0][ 2]  [    ][    ][    ][  ][RIGHT][    ]
[231][2030][0][ 0]  [    ][    ][    ][  ][     ][    ]
[232][2037][0][ 2]  [    ][    ][    ][  ][RIGHT][    ]
[233][2042][0][18]  [    ][JUMP][    ][  ][RIGHT][    ]
[234][2060][0][ 2]  [    ][    ][    ][  ][RIGHT][    ]
[235][2068][0][ 0]  [    ][    ][    ][  ][     ][    ]
[236][2073][0][16]  [    ][JUMP][    ][  ][     ][    ]
[237][2089][0][17]  [    ][JUMP][    ][  ][     ][LEFT]
[238][2093][0][16]  [    ][JUMP][    ][  ][     ][    ]
[239][2097][0][17]  [    ][JUMP][    ][  ][     ][LEFT]
[240][2103][0][ 1]  [    ][    ][    ][  ][     ][LEFT]
[241][2108][0][ 0]  [    ][    ][    ][  ][     ][    ]
[242][2113][0][ 2]  [    ][    ][    ][  ][RIGHT][    ]
[243][2120][0][18]  [    ][JUMP][    ][  ][RIGHT][    ]
[244][2147][0][ 6]  [    ][    ][    ][UP][RIGHT][    ]
[245][2148][0][ 4]  [    ][    ][    ][UP][     ][    ]
[246][2151][0][36]  [FIRE][    ][    ][UP][     ][    ]
[247][2156][0][ 4]  [    ][    ][    ][UP][     ][    ]
[248][2160][0][36]  [FIRE][    ][    ][UP][     ][    ]
[249][2163][0][ 5]  [    ][    ][    ][UP][     ][LEFT]
[250][2169][0][36]  [FIRE][    ][    ][UP][     ][    ]
[251][2172][0][ 4]  [    ][    ][    ][UP][     ][    ]
[252][2177][0][36]  [FIRE][    ][    ][UP][     ][    ]
[253][2181][0][ 4]  [    ][    ][    ][UP][     ][    ]
[254][2185][0][36]  [FIRE][    ][    ][UP][     ][    ]
[255][2188][0][ 4]  [    ][    ][    ][UP][     ][    ]
[256][2193][0][36]  [FIRE][    ][    ][UP][     ][    ]
[257][2195][0][ 4]  [    ][    ][    ][UP][     ][    ]
[258][2197][0][ 0]  [    ][    ][    ][  ][     ][    ]
[259][2204][0][ 8]  [    ][    ][DOWN][  ][     ][    ]
[260][2207][0][40]  [FIRE][    ][DOWN][  ][     ][    ]
[261][2211][0][ 8]  [    ][    ][DOWN][  ][     ][    ]
[262][2216][0][40]  [FIRE][    ][DOWN][  ][     ][    ]
[263][2219][0][ 8]  [    ][    ][DOWN][  ][     ][    ]
[264][2224][0][40]  [FIRE][    ][DOWN][  ][     ][    ]
[265][2227][0][ 8]  [    ][    ][DOWN][  ][     ][    ]
[266][2232][0][40]  [FIRE][    ][DOWN][  ][     ][    ]
[267][2235][0][ 8]  [    ][    ][DOWN][  ][     ][    ]
[268][2237][0][ 0]  [    ][    ][    ][  ][     ][    ]
[269][2251][0][16]  [    ][JUMP][    ][  ][     ][    ]
[270][2269][0][ 0]  [    ][    ][    ][  ][     ][    ]
[271][2276][0][ 2]  [    ][    ][    ][  ][RIGHT][    ]
[272][2289][0][18]  [    ][JUMP][    ][  ][RIGHT][    ]
[273][2301][0][ 2]  [    ][    ][    ][  ][RIGHT][    ]
[274][2305][0][ 0]  [    ][    ][    ][  ][     ][    ]
[275][2318][0][ 1]  [    ][    ][    ][  ][     ][LEFT]
[276][2320][0][ 0]  [    ][    ][    ][  ][     ][    ]
[277][2325][0][ 2]  [    ][    ][    ][  ][RIGHT][    ]
[278][2330][0][ 0]  [    ][    ][    ][  ][     ][    ]
[279][2331][0][ 1]  [    ][    ][    ][  ][     ][LEFT]
[280][2332][0][ 0]  [    ][    ][    ][  ][     ][    ]
[281][2335][0][ 2]  [    ][    ][    ][  ][RIGHT][    ]
[282][2339][0][ 1]  [    ][    ][    ][  ][     ][LEFT]
[283][2343][0][ 0]  [    ][    ][    ][  ][     ][    ]
[284][2344][0][ 2]  [    ][    ][    ][  ][RIGHT][    ]
[285][2348][0][ 3]  [    ][    ][    ][  ][RIGHT][LEFT]
[286][2349][0][ 1]  [    ][    ][    ][  ][     ][LEFT]
[287][2354][0][ 2]  [    ][    ][    ][  ][RIGHT][    ]
[288][2359][0][ 1]  [    ][    ][    ][  ][     ][LEFT]
[289][2364][0][ 0]  [    ][    ][    ][  ][     ][    ]
[290][2369][0][16]  [    ][JUMP][    ][  ][     ][    ]
[291][2376][0][18]  [    ][JUMP][    ][  ][RIGHT][    ]
[292][2389][0][ 2]  [    ][    ][    ][  ][RIGHT][    ]
[293][2391][0][ 0]  [    ][    ][    ][  ][     ][    ]
[294][2400][0][ 2]  [    ][    ][    ][  ][RIGHT][    ]
[295][2407]-------------LEVEL DONE 1 ---------------- 
[296][2487]-------------LEVEL DONE 2 ---------------- 
[297][3207]-------------NEXT LEVEL!------------------ 
[298][2506]-------------PLAYER 0 ACKNOWLEDGE------ 
[299][2507]-------------NEXT LEVEL!------------------ 
