number of entries 123
deathmatch_pbullets 0
deathmatch_pbullets_damage 5
suicide_pbullets 0
[ gm][  pc][p][cm]
[  0][   0]-------------START (level:15)------------- 
[  1][   0]-------------PLAYER 0 ACTIVE (color:8)-- 
[  2][  41][0][ 2]  [    ][    ][    ][  ][RIGHT][    ]
[  3][  49][0][ 0]  [    ][    ][    ][  ][     ][    ]
[  4][ 327][0][ 2]  [    ][    ][    ][  ][RIGHT][    ]
[  5][ 331][0][ 0]  [    ][    ][    ][  ][     ][    ]
[  6][ 545][0][16]  [    ][JUMP][    ][  ][     ][    ]
[  7][ 559][0][ 0]  [    ][    ][    ][  ][     ][    ]
[  8][ 586][0][ 2]  [    ][    ][    ][  ][RIGHT][    ]
[  9][ 590][0][18]  [    ][JUMP][    ][  ][RIGHT][    ]
[ 10][ 605][0][50]  [FIRE][JUMP][    ][  ][RIGHT][    ]
[ 11][ 606][0][34]  [FIRE][    ][    ][  ][RIGHT][    ]
[ 12][ 609][0][ 2]  [    ][    ][    ][  ][RIGHT][    ]
[ 13][ 611][0][34]  [FIRE][    ][    ][  ][RIGHT][    ]
[ 14][ 614][0][ 2]  [    ][    ][    ][  ][RIGHT][    ]
[ 15][ 618][0][34]  [FIRE][    ][    ][  ][RIGHT][    ]
[ 16][ 621][0][ 2]  [    ][    ][    ][  ][RIGHT][    ]
[ 17][ 624][0][34]  [FIRE][    ][    ][  ][RIGHT][    ]
[ 18][ 627][0][ 2]  [    ][    ][    ][  ][RIGHT][    ]
[ 19][ 631][0][34]  [FIRE][    ][    ][  ][RIGHT][    ]
[ 20][ 636][0][ 2]  [    ][    ][    ][  ][RIGHT][    ]
[ 21][ 640][0][18]  [    ][JUMP][    ][  ][RIGHT][    ]
[ 22][ 649][0][ 2]  [    ][    ][    ][  ][RIGHT][    ]
[ 23][ 697][0][ 0]  [    ][    ][    ][  ][     ][    ]
[ 24][ 708][0][ 2]  [    ][    ][    ][  ][RIGHT][    ]
[ 25][ 716][0][ 0]  [    ][    ][    ][  ][     ][    ]
[ 26][ 797][0][16]  [    ][JUMP][    ][  ][     ][    ]
[ 27][ 803][0][20]  [    ][JUMP][    ][UP][     ][    ]
[ 28][ 804][0][52]  [FIRE][JUMP][    ][UP][     ][    ]
[ 29][ 806][0][36]  [FIRE][    ][    ][UP][     ][    ]
[ 30][ 808][0][ 4]  [    ][    ][    ][UP][     ][    ]
[ 31][ 811][0][36]  [FIRE][    ][    ][UP][     ][    ]
[ 32][ 814][0][ 4]  [    ][    ][    ][UP][     ][    ]
[ 33][ 817][0][36]  [FIRE][    ][    ][UP][     ][    ]
[ 34][ 820][0][38]  [FIRE][    ][    ][UP][RIGHT][    ]
[ 35][ 821][0][ 6]  [    ][    ][    ][UP][RIGHT][    ]
[ 36][ 824][0][17]  [    ][JUMP][    ][  ][     ][LEFT]
[ 37][ 826][0][49]  [FIRE][JUMP][    ][  ][     ][LEFT]
[ 38][ 828][0][55]  [FIRE][JUMP][    ][UP][RIGHT][LEFT]
[ 39][ 829][0][38]  [FIRE][    ][    ][UP][RIGHT][    ]
[ 40][ 832][0][23]  [    ][JUMP][    ][UP][RIGHT][LEFT]
[ 41][ 833][0][17]  [    ][JUMP][    ][  ][     ][LEFT]
[ 42][ 836][0][54]  [FIRE][JUMP][    ][UP][RIGHT][    ]
[ 43][ 837][0][38]  [FIRE][    ][    ][UP][RIGHT][    ]
[ 44][ 840][0][22]  [    ][JUMP][    ][UP][RIGHT][    ]
[ 45][ 843][0][ 6]  [    ][    ][    ][UP][RIGHT][    ]
[ 46][ 845][0][ 2]  [    ][    ][    ][  ][RIGHT][    ]
[ 47][ 846][0][ 0]  [    ][    ][    ][  ][     ][    ]
[ 48][ 971][0][16]  [    ][JUMP][    ][  ][     ][    ]
[ 49][ 987][0][ 0]  [    ][    ][    ][  ][     ][    ]
[ 50][1003][0][ 1]  [    ][    ][    ][  ][     ][LEFT]
[ 51][1006][0][32]  [FIRE][    ][    ][  ][     ][    ]
[ 52][1009][0][ 0]  [    ][    ][    ][  ][     ][    ]
[ 53][1012][0][32]  [FIRE][    ][    ][  ][     ][    ]
[ 54][1014][0][ 0]  [    ][    ][    ][  ][     ][    ]
[ 55][1018][0][32]  [FIRE][    ][    ][  ][     ][    ]
[ 56][1020][0][ 0]  [    ][    ][    ][  ][     ][    ]
[ 57][1035][0][ 1]  [    ][    ][    ][  ][     ][LEFT]
[ 58][1048][0][ 0]  [    ][    ][    ][  ][     ][    ]
[ 59][1051][0][ 2]  [    ][    ][    ][  ][RIGHT][    ]
[ 60][1057][0][34]  [FIRE][    ][    ][  ][RIGHT][    ]
[ 61][1066][0][50]  [FIRE][JUMP][    ][  ][RIGHT][    ]
[ 62][1079][0][34]  [FIRE][    ][    ][  ][RIGHT][    ]
[ 63][1085][0][ 2]  [    ][    ][    ][  ][RIGHT][    ]
[ 64][1087][0][ 0]  [    ][    ][    ][  ][     ][    ]
[ 65][1125][0][ 2]  [    ][    ][    ][  ][RIGHT][    ]
[ 66][1128][0][34]  [FIRE][    ][    ][  ][RIGHT][    ]
[ 67][1137][0][50]  [FIRE][JUMP][    ][  ][RIGHT][    ]
[ 68][1153][0][ 2]  [    ][    ][    ][  ][RIGHT][    ]
[ 69][1195][0][18]  [    ][JUMP][    ][  ][RIGHT][    ]
[ 70][1201][0][ 2]  [    ][    ][    ][  ][RIGHT][    ]
[ 71][1225][0][18]  [    ][JUMP][    ][  ][RIGHT][    ]
[ 72][1231][0][ 2]  [    ][    ][    ][  ][RIGHT][    ]
[ 73][1251][0][ 0]  [    ][    ][    ][  ][     ][    ]
[ 74][1255][0][ 1]  [    ][    ][    ][  ][     ][LEFT]
[ 75][1302][0][ 0]  [    ][    ][    ][  ][     ][    ]
[ 76][1321][0][ 1]  [    ][    ][    ][  ][     ][LEFT]
[ 77][1345][0][ 0]  [    ][    ][    ][  ][     ][    ]
[ 78][1369][0][ 1]  [    ][    ][    ][  ][     ][LEFT]
[ 79][1372][0][ 0]  [    ][    ][    ][  ][     ][    ]
[ 80][1376][0][ 1]  [    ][    ][    ][  ][     ][LEFT]
[ 81][1383][0][17]  [    ][JUMP][    ][  ][     ][LEFT]
[ 82][1399][0][ 1]  [    ][    ][    ][  ][     ][LEFT]
[ 83][1430][0][ 0]  [    ][    ][    ][  ][     ][    ]
[ 84][1446][0][ 1]  [    ][    ][    ][  ][     ][LEFT]
[ 85][1450][0][17]  [    ][JUMP][    ][  ][     ][LEFT]
[ 86][1459][0][18]  [    ][JUMP][    ][  ][RIGHT][    ]
[ 87][1460][0][ 2]  [    ][    ][    ][  ][RIGHT][    ]
[ 88][1476][0][ 0]  [    ][    ][    ][  ][     ][    ]
[ 89][1487][0][16]  [    ][JUMP][    ][  ][     ][    ]
[ 90][1489][0][17]  [    ][JUMP][    ][  ][     ][LEFT]
[ 91][1501][0][ 1]  [    ][    ][    ][  ][     ][LEFT]
[ 92][1508][0][ 0]  [    ][    ][    ][  ][     ][    ]
[ 93][1512][0][ 1]  [    ][    ][    ][  ][     ][LEFT]
[ 94][1517][0][ 0]  [    ][    ][    ][  ][     ][    ]
[ 95][1571][0][ 2]  [    ][    ][    ][  ][RIGHT][    ]
[ 96][1575][0][18]  [    ][JUMP][    ][  ][RIGHT][    ]
[ 97][1586][0][ 2]  [    ][    ][    ][  ][RIGHT][    ]
[ 98][1599][0][ 0]  [    ][    ][    ][  ][     ][    ]
[ 99][1618][0][ 2]  [    ][    ][    ][  ][RIGHT][    ]
[100][1632][0][18]  [    ][JUMP][    ][  ][RIGHT][    ]
[101][1634][0][16]  [    ][JUMP][    ][  ][     ][    ]
[102][1677][0][ 0]  [    ][    ][    ][  ][     ][    ]
[103][1680][0][16]  [    ][JUMP][    ][  ][     ][    ]
[104][1698][0][ 0]  [    ][    ][    ][  ][     ][    ]
[105][1727][0][16]  [    ][JUMP][    ][  ][     ][    ]
[106][1756][0][ 0]  [    ][    ][    ][  ][     ][    ]
[107][1758][0][ 1]  [    ][    ][    ][  ][     ][LEFT]
[108][1764][0][ 0]  [    ][    ][    ][  ][     ][    ]
[109][1793][0][ 1]  [    ][    ][    ][  ][     ][LEFT]
[110][1797][0][ 0]  [    ][    ][    ][  ][     ][    ]
[111][1809][0][16]  [    ][JUMP][    ][  ][     ][    ]
[112][1821][0][18]  [    ][JUMP][    ][  ][RIGHT][    ]
[113][1823][0][ 2]  [    ][    ][    ][  ][RIGHT][    ]
[114][1826][0][ 0]  [    ][    ][    ][  ][     ][    ]
[115][1838][0][ 1]  [    ][    ][    ][  ][     ][LEFT]
[116][1842][0][ 0]  [    ][    ][    ][  ][     ][    ]
[117][1866][0][16]  [    ][JUMP][    ][  ][     ][    ]
[118][1888]-------------LEVEL DONE 1 ---------------- 
[119][1968]-------------LEVEL DONE 2 ---------------- 
[120][2688]-------------NEXT LEVEL!------------------ 
[121][2046]-------------PLAYER 0 ACKNOWLEDGE------ 
[122][2047]-------------NEXT LEVEL!------------------ 
